.;.;.;.;.;.;.;.;.;.;.;.;.;.;.;.;.;.;.;.;.;.;.;.;.;.;.;.;.;.;.;.;.;.;.;.;.;.;.;.;.;.;.;.;.;.;.;.;.;.;.;.;.;.;.;.;.;.;.;.;.;.;.;.
.;.;.;.;.;.;.;.;.;.;.;.;.;.;.;.;.;.;.;.;.;.;.;.;.;.;.;.;.;.;.;.;.;.;.;.;.;.;.;.;.;.;.;.;.;.;.;.;.;.;.;.;.;.;.;.;.;.;.;.;.;.;.;.
.;.;a;a;a;a;a;a;a;a;a;a;a;a;a;a;a;e;e;e;e;e;e;e;e;e;e;e;e;e;.;.;.;.;u;u;u;u;u;u;u;u;u;u;u;u;u;u;v;v;v;v;v;v;v;v;v;v;v;v;v;v;.;.
.;.;a;a;a;a;a;a;a;a;a;a;a;a;a;a;a;e;e;e;e;e;e;e;e;e;e;e;e;e;.;.;.;.;u;u;u;u;u;u;u;u;u;u;u;u;u;u;v;v;v;v;v;v;v;v;v;v;v;v;v;v;.;.
.;.;a;a;a;a;a;a;a;a;a;a;a;a;a;a;a;e;e;e;e;e;e;e;e;e;e;e;e;e;.;.;.;.;u;u;u;u;u;u;u;u;u;u;u;u;u;u;v;v;v;v;v;v;v;v;v;v;v;v;v;v;.;.
.;.;a;a;a;a;a;a;a;a;a;a;a;a;a;a;a;e;e;e;e;e;e;e;e;e;e;e;e;e;.;.;.;.;u;u;u;u;u;u;u;u;u;u;u;u;u;u;v;v;v;v;v;v;v;v;v;v;v;v;v;v;.;.
.;.;a;a;a;a;a;a;a;a;a;a;a;a;a;a;a;e;e;e;e;e;e;e;e;e;e;e;e;e;.;.;.;.;u;u;u;u;u;u;u;u;u;u;u;u;u;u;v;v;v;v;v;v;v;v;v;v;v;v;v;v;.;.
.;.;a;a;a;a;a;a;a;a;a;a;a;a;a;a;a;e;e;e;e;e;e;e;e;e;e;e;e;e;.;.;.;.;u;u;u;u;u;u;u;u;u;u;u;u;u;u;v;v;v;v;v;v;v;v;v;v;v;v;v;v;.;.
.;.;a;a;a;a;a;a;a;a;a;a;a;a;a;a;a;e;e;e;e;e;e;e;e;e;e;e;e;e;.;.;.;.;u;u;u;u;u;u;u;u;u;u;u;u;u;u;v;v;v;v;v;v;v;v;v;v;v;v;v;v;.;.
.;.;a;a;a;a;a;a;a;a;a;a;a;a;a;a;a;e;e;e;e;e;e;e;e;e;e;e;e;e;.;.;.;.;u;u;u;u;u;u;u;u;u;u;u;u;u;u;v;v;v;v;v;v;v;v;v;v;v;v;v;v;.;.
.;.;a;a;a;a;a;a;a;a;a;a;a;a;a;a;a;e;e;e;e;e;e;e;e;e;e;e;e;e;.;.;.;.;u;u;u;u;u;u;u;u;u;u;u;u;u;u;v;v;v;v;v;v;v;v;v;v;v;v;v;v;.;.
.;.;a;a;a;a;a;a;a;a;a;a;a;a;a;a;a;e;e;e;e;e;e;e;e;e;e;e;e;e;.;.;.;.;u;u;u;u;u;u;u;u;u;u;u;u;u;u;v;v;v;v;v;v;v;v;v;v;v;v;v;v;.;.
.;.;a;a;a;a;a;a;a;a;a;a;a;a;a;a;a;e;e;e;e;e;e;e;e;e;e;e;e;e;.;.;.;.;u;u;u;u;u;u;u;u;u;u;u;u;u;u;v;v;v;v;v;v;v;v;v;v;v;v;v;v;.;.
.;.;a;a;a;a;a;a;a;a;a;a;a;a;a;a;a;e;e;e;e;e;e;e;e;e;e;e;e;e;.;.;.;.;u;u;u;u;u;u;u;u;u;u;u;u;u;u;v;v;v;v;v;v;v;v;v;v;v;v;v;v;.;.
.;.;a;a;a;a;a;a;a;a;a;a;a;a;a;a;a;e;e;e;e;e;e;e;e;e;e;e;e;e;.;.;.;.;u;u;u;u;u;u;u;u;u;u;u;u;u;u;v;v;v;v;v;v;v;v;v;v;v;v;v;v;.;.
.;.;a;a;a;a;a;a;a;a;a;a;a;a;a;a;a;e;e;e;e;e;e;e;e;e;e;e;e;e;.;.;.;.;u;u;u;u;u;u;u;u;u;u;u;u;u;u;v;v;v;v;v;v;v;v;v;v;v;v;v;v;.;.
.;.;g;g;g;g;g;g;g;g;g;g;g;g;g;g;g;.;.;.;.;.;.;.;.;.;.;.;.;.;.;.;.;.;.;.;.;.;.;.;.;.;.;.;.;.;.;.;w;w;w;w;w;w;w;w;w;w;w;w;w;w;.;.
.;.;g;g;g;g;g;g;g;g;g;g;g;g;g;g;g;.;.;.;.;.;.;.;.;.;.;.;.;.;.;.;.;.;.;.;.;.;.;.;.;.;.;.;.;.;.;.;w;w;w;w;w;w;w;w;w;w;w;w;w;w;.;.
.;.;g;g;g;g;g;g;g;g;g;g;g;g;g;g;g;.;.;p;p;p;p;p;p;p;p;p;p;p;p;p;q;q;q;q;q;q;q;q;q;q;q;q;q;q;.;.;w;w;w;w;w;w;w;w;w;w;w;w;w;w;.;.
.;.;g;g;g;g;g;g;g;g;g;g;g;g;g;g;g;.;.;p;p;p;p;p;p;p;p;p;p;p;p;p;q;q;q;q;q;q;q;q;q;q;q;q;q;q;.;.;w;w;w;w;w;w;w;w;w;w;w;w;w;w;.;.
.;.;g;g;g;g;g;g;g;g;g;g;g;g;g;g;g;.;.;p;p;p;p;p;p;p;p;p;p;p;p;p;q;q;q;q;q;q;q;q;q;q;q;q;q;q;.;.;w;w;w;w;w;w;w;w;w;w;w;w;w;w;.;.
.;.;g;g;g;g;g;g;g;g;g;g;g;g;g;g;g;.;.;p;p;p;p;p;p;p;p;p;p;p;p;p;q;q;q;q;q;q;q;q;q;q;q;q;q;q;.;.;w;w;w;w;w;w;w;w;w;w;w;w;w;w;.;.
.;.;g;g;g;g;g;g;g;g;g;g;g;g;g;g;g;.;.;p;p;p;p;p;p;p;p;p;p;p;p;p;q;q;q;q;q;q;q;q;q;q;q;q;q;q;.;.;w;w;w;w;w;w;w;w;w;w;w;w;w;w;.;.
.;.;g;g;g;g;g;g;g;g;g;g;g;g;g;g;g;.;.;p;p;p;p;p;p;p;p;p;p;p;p;p;q;q;q;q;q;q;q;q;q;q;q;q;q;q;.;.;w;w;w;w;w;w;w;w;w;w;w;w;w;w;.;.
.;.;g;g;g;g;g;g;g;g;g;g;g;g;g;g;g;.;.;p;p;p;p;p;p;p;p;p;p;p;p;p;q;q;q;q;q;q;q;q;q;q;q;q;q;q;.;.;w;w;w;w;w;w;w;w;w;w;w;w;w;w;.;.
.;.;g;g;g;g;g;g;g;g;g;g;g;g;g;g;g;.;.;p;p;p;p;p;p;p;p;p;p;p;p;p;q;q;q;q;q;q;q;q;q;q;q;q;q;q;.;.;w;w;w;w;w;w;w;w;w;w;w;w;w;w;.;.
.;.;g;g;g;g;g;g;g;g;g;g;g;g;g;g;g;.;.;p;p;p;p;p;p;p;p;p;p;p;p;p;q;q;q;q;q;q;q;q;q;q;q;q;q;q;.;.;w;w;w;w;w;w;w;w;w;w;w;w;w;w;.;.
.;.;g;g;g;g;g;g;g;g;g;g;g;g;g;g;g;.;.;p;p;p;p;p;p;p;p;p;p;p;p;p;q;q;q;q;q;q;q;q;q;q;q;q;q;q;.;.;w;w;w;w;w;w;w;w;w;w;w;w;w;w;.;.
.;.;g;g;g;g;g;g;g;g;g;g;g;g;g;g;g;.;.;p;p;p;p;p;p;p;p;p;p;p;p;p;q;q;q;q;q;q;q;q;q;q;q;q;q;q;.;.;w;w;w;w;w;w;w;w;w;w;w;w;w;w;.;.
.;.;g;g;g;g;g;g;g;g;g;g;g;g;g;g;g;.;.;p;p;p;p;p;p;p;p;p;p;p;p;p;q;q;q;q;q;q;q;q;q;q;q;q;q;q;.;.;w;w;w;w;w;w;w;w;w;w;w;w;w;w;.;.
.;.;g;g;g;g;g;g;g;g;g;g;g;g;g;g;g;.;.;p;p;p;p;p;p;p;p;p;p;p;p;p;q;q;q;q;q;q;q;q;q;q;q;q;q;q;.;.;w;w;w;w;w;w;w;w;w;w;w;w;w;w;.;.
.;.;.;.;.;.;.;.;.;.;.;.;.;.;.;.;.;.;.;p;p;p;p;p;p;p;p;p;p;p;p;p;q;q;q;q;q;q;q;q;q;q;q;q;q;q;.;.;.;.;.;.;.;.;.;.;.;.;.;.;.;.;.;.
.;.;.;.;.;.;.;.;.;.;.;.;.;.;.;.;.;.;.;p;p;p;p;p;p;p;p;p;p;p;p;p;q;q;q;q;q;q;q;q;q;q;q;q;q;q;.;.;.;.;.;.;.;.;.;.;.;.;.;.;.;.;.;.
.;.;.;.;.;.;.;.;.;.;.;.;.;.;.;.;.;.;.;b;b;b;b;b;b;b;b;b;b;b;b;b;d;d;d;d;d;d;d;d;d;d;d;d;d;d;.;.;.;.;.;.;.;.;.;.;.;.;.;.;.;.;.;.
.;.;.;.;.;.;.;.;.;.;.;.;.;.;.;.;.;.;.;b;b;b;b;b;b;b;b;b;b;b;b;b;d;d;d;d;d;d;d;d;d;d;d;d;d;d;.;.;.;.;.;.;.;.;.;.;.;.;.;.;.;.;.;.
.;.;t;t;t;t;t;t;t;t;t;t;t;t;t;t;t;.;.;b;b;b;b;b;b;b;b;b;b;b;b;b;d;d;d;d;d;d;d;d;d;d;d;d;d;d;.;.;6;6;6;6;6;6;6;6;6;6;6;6;6;6;.;.
.;.;t;t;t;t;t;t;t;t;t;t;t;t;t;t;t;.;.;b;b;b;b;b;b;b;b;b;b;b;b;b;d;d;d;d;d;d;d;d;d;d;d;d;d;d;.;.;6;6;6;6;6;6;6;6;6;6;6;6;6;6;.;.
.;.;t;t;t;t;t;t;t;t;t;t;t;t;t;t;t;.;.;b;b;b;b;b;b;b;b;b;b;b;b;b;d;d;d;d;d;d;d;d;d;d;d;d;d;d;.;.;6;6;6;6;6;6;6;6;6;6;6;6;6;6;.;.
.;.;t;t;t;t;t;t;t;t;t;t;t;t;t;t;t;.;.;b;b;b;b;b;b;b;b;b;b;b;b;b;d;d;d;d;d;d;d;d;d;d;d;d;d;d;.;.;6;6;6;6;6;6;6;6;6;6;6;6;6;6;.;.
.;.;t;t;t;t;t;t;t;t;t;t;t;t;t;t;t;.;.;b;b;b;b;b;b;b;b;b;b;b;b;b;d;d;d;d;d;d;d;d;d;d;d;d;d;d;.;.;6;6;6;6;6;6;6;6;6;6;6;6;6;6;.;.
.;.;t;t;t;t;t;t;t;t;t;t;t;t;t;t;t;.;.;b;b;b;b;b;b;b;b;b;b;b;b;b;d;d;d;d;d;d;d;d;d;d;d;d;d;d;.;.;6;6;6;6;6;6;6;6;6;6;6;6;6;6;.;.
.;.;t;t;t;t;t;t;t;t;t;t;t;t;t;t;t;.;.;b;b;b;b;b;b;b;b;b;b;b;b;b;d;d;d;d;d;d;d;d;d;d;d;d;d;d;.;.;6;6;6;6;6;6;6;6;6;6;6;6;6;6;.;.
.;.;t;t;t;t;t;t;t;t;t;t;t;t;t;t;t;.;.;b;b;b;b;b;b;b;b;b;b;b;b;b;d;d;d;d;d;d;d;d;d;d;d;d;d;d;.;.;6;6;6;6;6;6;6;6;6;6;6;6;6;6;.;.
.;.;t;t;t;t;t;t;t;t;t;t;t;t;t;t;t;.;.;b;b;b;b;b;b;b;b;b;b;b;b;b;d;d;d;d;d;d;d;d;d;d;d;d;d;d;.;.;6;6;6;6;6;6;6;6;6;6;6;6;6;6;.;.
.;.;t;t;t;t;t;t;t;t;t;t;t;t;t;t;t;.;.;b;b;b;b;b;b;b;b;b;b;b;b;b;d;d;d;d;d;d;d;d;d;d;d;d;d;d;.;.;6;6;6;6;6;6;6;6;6;6;6;6;6;6;.;.
.;.;t;t;t;t;t;t;t;t;t;t;t;t;t;t;t;.;.;b;b;b;b;b;b;b;b;b;b;b;b;b;d;d;d;d;d;d;d;d;d;d;d;d;d;d;.;.;6;6;6;6;6;6;6;6;6;6;6;6;6;6;.;.
.;.;t;t;t;t;t;t;t;t;t;t;t;t;t;t;t;.;.;.;.;.;.;.;.;.;.;.;.;.;.;.;.;.;.;.;.;.;.;.;.;.;.;.;.;.;.;.;6;6;6;6;6;6;6;6;6;6;6;6;6;6;.;.
.;.;t;t;t;t;t;t;t;t;t;t;t;t;t;t;t;.;.;.;.;.;.;.;.;.;.;.;.;.;.;.;.;.;.;.;.;.;.;.;.;.;.;.;.;.;.;.;6;6;6;6;6;6;6;6;6;6;6;6;6;6;.;.
.;.;t;t;t;t;t;t;t;t;t;t;t;t;t;t;t;.;.;.;.;.;.;.;.;.;.;.;.;.;.;.;.;.;.;.;.;.;.;.;.;.;.;.;.;.;.;.;6;6;6;6;6;6;6;6;6;6;6;6;6;6;.;.
.;.;r;r;r;r;r;r;r;r;r;r;r;r;r;r;r;i;i;i;i;i;i;i;i;i;i;i;i;i;.;.;.;.;9;9;9;9;9;9;9;9;9;9;9;9;9;9;8;8;8;8;8;8;8;8;8;8;8;8;8;8;.;.
.;.;r;r;r;r;r;r;r;r;r;r;r;r;r;r;r;i;i;i;i;i;i;i;i;i;i;i;i;i;.;.;.;.;9;9;9;9;9;9;9;9;9;9;9;9;9;9;8;8;8;8;8;8;8;8;8;8;8;8;8;8;.;.
.;.;r;r;r;r;r;r;r;r;r;r;r;r;r;r;r;i;i;i;i;i;i;i;i;i;i;i;i;i;.;.;.;.;9;9;9;9;9;9;9;9;9;9;9;9;9;9;8;8;8;8;8;8;8;8;8;8;8;8;8;8;.;.
.;.;r;r;r;r;r;r;r;r;r;r;r;r;r;r;r;i;i;i;i;i;i;i;i;i;i;i;i;i;.;.;.;.;9;9;9;9;9;9;9;9;9;9;9;9;9;9;8;8;8;8;8;8;8;8;8;8;8;8;8;8;.;.
.;.;r;r;r;r;r;r;r;r;r;r;r;r;r;r;r;i;i;i;i;i;i;i;i;i;i;i;i;i;.;.;.;.;9;9;9;9;9;9;9;9;9;9;9;9;9;9;8;8;8;8;8;8;8;8;8;8;8;8;8;8;.;.
.;.;r;r;r;r;r;r;r;r;r;r;r;r;r;r;r;i;i;i;i;i;i;i;i;i;i;i;i;i;.;.;.;.;9;9;9;9;9;9;9;9;9;9;9;9;9;9;8;8;8;8;8;8;8;8;8;8;8;8;8;8;.;.
.;.;r;r;r;r;r;r;r;r;r;r;r;r;r;r;r;i;i;i;i;i;i;i;i;i;i;i;i;i;.;.;.;.;9;9;9;9;9;9;9;9;9;9;9;9;9;9;8;8;8;8;8;8;8;8;8;8;8;8;8;8;.;.
.;.;r;r;r;r;r;r;r;r;r;r;r;r;r;r;r;i;i;i;i;i;i;i;i;i;i;i;i;i;.;.;.;.;9;9;9;9;9;9;9;9;9;9;9;9;9;9;8;8;8;8;8;8;8;8;8;8;8;8;8;8;.;.
.;.;r;r;r;r;r;r;r;r;r;r;r;r;r;r;r;i;i;i;i;i;i;i;i;i;i;i;i;i;.;.;.;.;9;9;9;9;9;9;9;9;9;9;9;9;9;9;8;8;8;8;8;8;8;8;8;8;8;8;8;8;.;.
.;.;r;r;r;r;r;r;r;r;r;r;r;r;r;r;r;i;i;i;i;i;i;i;i;i;i;i;i;i;.;.;.;.;9;9;9;9;9;9;9;9;9;9;9;9;9;9;8;8;8;8;8;8;8;8;8;8;8;8;8;8;.;.
.;.;r;r;r;r;r;r;r;r;r;r;r;r;r;r;r;i;i;i;i;i;i;i;i;i;i;i;i;i;.;.;.;.;9;9;9;9;9;9;9;9;9;9;9;9;9;9;8;8;8;8;8;8;8;8;8;8;8;8;8;8;.;.
.;.;r;r;r;r;r;r;r;r;r;r;r;r;r;r;r;i;i;i;i;i;i;i;i;i;i;i;i;i;.;.;.;.;9;9;9;9;9;9;9;9;9;9;9;9;9;9;8;8;8;8;8;8;8;8;8;8;8;8;8;8;.;.
.;.;r;r;r;r;r;r;r;r;r;r;r;r;r;r;r;i;i;i;i;i;i;i;i;i;i;i;i;i;.;.;.;.;9;9;9;9;9;9;9;9;9;9;9;9;9;9;8;8;8;8;8;8;8;8;8;8;8;8;8;8;.;.
.;.;.;.;.;.;.;.;.;.;.;.;.;.;.;.;.;.;.;.;.;.;.;.;.;.;.;.;.;.;.;.;.;.;.;.;.;.;.;.;.;.;.;.;.;.;.;.;.;.;.;.;.;.;.;.;.;.;.;.;.;.;.;.
.;.;.;.;.;.;.;.;.;.;.;.;.;.;.;.;.;.;.;.;.;.;.;.;.;.;.;.;.;.;.;.;.;.;.;.;.;.;.;.;.;.;.;.;.;.;.;.;.;.;.;.;.;.;.;.;.;.;.;.;.;.;.;.
