.;.;.;.;.;.;.;.;.;.;.;.;.;.;.;.;.;.;.;.;.;.;.;.;.;.;.;.;.;.;.;.;.;.;.;.;.;.;.;.;.;.;.;.;.;.;.;.;.;.;.;.;.;.;.;.;.;.;.;.;.;.;.;.
.;.;.;.;.;.;.;.;.;.;.;.;.;.;.;.;.;.;.;.;.;.;.;.;.;.;.;.;.;.;.;.;.;.;.;.;.;.;.;.;.;.;.;.;.;.;.;.;.;.;.;.;.;.;.;.;.;.;.;.;.;.;.;.
.;.;a;a;a;a;a;a;a;a;a;.;e;e;e;e;e;e;e;e;e;.;c;c;c;c;c;c;c;c;c;.;o;o;o;o;o;o;o;o;o;.;e;e;e;e;e;e;e;e;e;.;x;x;x;x;x;x;x;x;x;.;.;.
.;.;a;a;a;a;a;a;a;a;a;.;e;e;e;e;e;e;e;e;e;.;c;c;c;c;c;c;c;c;c;.;o;o;o;o;o;o;o;o;o;.;e;e;e;e;e;e;e;e;e;.;x;x;x;x;x;x;x;x;x;.;.;.
.;.;a;a;a;a;a;a;a;a;a;.;e;e;e;e;e;e;e;e;e;.;c;c;c;c;c;c;c;c;c;.;o;o;o;o;o;o;o;o;o;.;e;e;e;e;e;e;e;e;e;.;x;x;x;x;x;x;x;x;x;.;.;.
.;.;a;a;a;a;a;a;a;a;a;.;e;e;e;e;e;e;e;e;e;.;c;c;c;c;c;c;c;c;c;.;o;o;o;o;o;o;o;o;o;.;e;e;e;e;e;e;e;e;e;.;x;x;x;x;x;x;x;x;x;.;.;.
.;.;a;a;a;a;a;a;a;a;a;.;e;e;e;e;e;e;e;e;e;.;c;c;c;c;c;c;c;c;c;.;o;o;o;o;o;o;o;o;o;.;e;e;e;e;e;e;e;e;e;.;x;x;x;x;x;x;x;x;x;.;.;.
.;.;a;a;a;a;a;a;a;a;a;.;e;e;e;e;e;e;e;e;e;.;c;c;c;c;c;c;c;c;c;.;o;o;o;o;o;o;o;o;o;.;e;e;e;e;e;e;e;e;e;.;x;x;x;x;x;x;x;x;x;.;.;.
.;.;a;a;a;a;a;a;a;a;a;.;e;e;e;e;e;e;e;e;e;.;c;c;c;c;c;c;c;c;c;.;o;o;o;o;o;o;o;o;o;.;e;e;e;e;e;e;e;e;e;.;x;x;x;x;x;x;x;x;x;.;.;.
.;.;a;a;a;a;a;a;a;a;a;.;e;e;e;e;e;e;e;e;e;.;c;c;c;c;c;c;c;c;c;.;o;o;o;o;o;o;o;o;o;.;e;e;e;e;e;e;e;e;e;.;x;x;x;x;x;x;x;x;x;.;.;.
.;.;a;a;a;a;a;a;a;a;a;.;e;e;e;e;e;e;e;e;e;.;c;c;c;c;c;c;c;c;c;.;o;o;o;o;o;o;o;o;o;.;e;e;e;e;e;e;e;e;e;.;x;x;x;x;x;x;x;x;x;.;.;.
.;.;.;.;.;.;.;.;.;.;.;.;.;.;.;.;.;.;.;.;.;.;.;.;.;.;.;.;.;.;.;.;.;.;.;.;.;.;.;.;.;.;.;.;.;.;.;.;.;.;.;.;.;.;.;.;.;.;.;.;.;.;.;.
.;.;s;s;s;s;s;s;s;s;s;.;b;b;b;b;b;b;b;b;b;.;d;d;d;d;d;d;d;d;d;.;q;q;q;q;q;q;q;q;q;.;p;p;p;p;p;p;p;p;p;.;g;g;g;g;g;g;g;g;g;.;.;.
.;.;s;s;s;s;s;s;s;s;s;.;b;b;b;b;b;b;b;b;b;.;d;d;d;d;d;d;d;d;d;.;q;q;q;q;q;q;q;q;q;.;p;p;p;p;p;p;p;p;p;.;g;g;g;g;g;g;g;g;g;.;.;.
.;.;s;s;s;s;s;s;s;s;s;.;b;b;b;b;b;b;b;b;b;.;d;d;d;d;d;d;d;d;d;.;q;q;q;q;q;q;q;q;q;.;p;p;p;p;p;p;p;p;p;.;g;g;g;g;g;g;g;g;g;.;.;.
.;.;s;s;s;s;s;s;s;s;s;.;b;b;b;b;b;b;b;b;b;.;d;d;d;d;d;d;d;d;d;.;q;q;q;q;q;q;q;q;q;.;p;p;p;p;p;p;p;p;p;.;g;g;g;g;g;g;g;g;g;.;.;.
.;.;s;s;s;s;s;s;s;s;s;.;b;b;b;b;b;b;b;b;b;.;d;d;d;d;d;d;d;d;d;.;q;q;q;q;q;q;q;q;q;.;p;p;p;p;p;p;p;p;p;.;g;g;g;g;g;g;g;g;g;.;.;.
.;.;s;s;s;s;s;s;s;s;s;.;b;b;b;b;b;b;b;b;b;.;d;d;d;d;d;d;d;d;d;.;q;q;q;q;q;q;q;q;q;.;p;p;p;p;p;p;p;p;p;.;g;g;g;g;g;g;g;g;g;.;.;.
.;.;s;s;s;s;s;s;s;s;s;.;b;b;b;b;b;b;b;b;b;.;d;d;d;d;d;d;d;d;d;.;q;q;q;q;q;q;q;q;q;.;p;p;p;p;p;p;p;p;p;.;g;g;g;g;g;g;g;g;g;.;.;.
.;.;s;s;s;s;s;s;s;s;s;.;b;b;b;b;b;b;b;b;b;.;d;d;d;d;d;d;d;d;d;.;q;q;q;q;q;q;q;q;q;.;p;p;p;p;p;p;p;p;p;.;g;g;g;g;g;g;g;g;g;.;.;.
.;.;s;s;s;s;s;s;s;s;s;.;b;b;b;b;b;b;b;b;b;.;d;d;d;d;d;d;d;d;d;.;q;q;q;q;q;q;q;q;q;.;p;p;p;p;p;p;p;p;p;.;g;g;g;g;g;g;g;g;g;.;.;.
.;.;.;.;.;.;.;.;.;.;.;.;.;.;.;.;.;.;.;.;.;.;.;.;.;.;.;.;.;.;.;.;.;.;.;.;.;.;.;.;.;.;.;.;.;.;.;.;.;.;.;.;.;.;.;.;.;.;.;.;.;.;.;.
.;.;u;u;u;u;u;u;u;u;u;.;v;v;v;v;v;v;v;v;v;.;w;w;w;w;w;w;w;w;w;.;m;m;m;m;m;m;m;m;m;.;n;n;n;n;n;n;n;n;n;.;h;h;h;h;h;h;h;h;h;.;.;.
.;.;u;u;u;u;u;u;u;u;u;.;v;v;v;v;v;v;v;v;v;.;w;w;w;w;w;w;w;w;w;.;m;m;m;m;m;m;m;m;m;.;n;n;n;n;n;n;n;n;n;.;h;h;h;h;h;h;h;h;h;.;.;.
.;.;u;u;u;u;u;u;u;u;u;.;v;v;v;v;v;v;v;v;v;.;w;w;w;w;w;w;w;w;w;.;m;m;m;m;m;m;m;m;m;.;n;n;n;n;n;n;n;n;n;.;h;h;h;h;h;h;h;h;h;.;.;.
.;.;u;u;u;u;u;u;u;u;u;.;v;v;v;v;v;v;v;v;v;.;w;w;w;w;w;w;w;w;w;.;m;m;m;m;m;m;m;m;m;.;n;n;n;n;n;n;n;n;n;.;h;h;h;h;h;h;h;h;h;.;.;.
.;.;u;u;u;u;u;u;u;u;u;.;v;v;v;v;v;v;v;v;v;.;w;w;w;w;w;w;w;w;w;.;m;m;m;m;m;m;m;m;m;.;n;n;n;n;n;n;n;n;n;.;h;h;h;h;h;h;h;h;h;.;.;.
.;.;u;u;u;u;u;u;u;u;u;.;v;v;v;v;v;v;v;v;v;.;w;w;w;w;w;w;w;w;w;.;m;m;m;m;m;m;m;m;m;.;n;n;n;n;n;n;n;n;n;.;h;h;h;h;h;h;h;h;h;.;.;.
.;.;u;u;u;u;u;u;u;u;u;.;v;v;v;v;v;v;v;v;v;.;w;w;w;w;w;w;w;w;w;.;m;m;m;m;m;m;m;m;m;.;n;n;n;n;n;n;n;n;n;.;h;h;h;h;h;h;h;h;h;.;.;.
.;.;u;u;u;u;u;u;u;u;u;.;v;v;v;v;v;v;v;v;v;.;w;w;w;w;w;w;w;w;w;.;m;m;m;m;m;m;m;m;m;.;n;n;n;n;n;n;n;n;n;.;h;h;h;h;h;h;h;h;h;.;.;.
.;.;u;u;u;u;u;u;u;u;u;.;v;v;v;v;v;v;v;v;v;.;w;w;w;w;w;w;w;w;w;.;m;m;m;m;m;m;m;m;m;.;n;n;n;n;n;n;n;n;n;.;h;h;h;h;h;h;h;h;h;.;.;.
.;.;.;.;.;.;.;.;.;.;.;.;.;.;.;.;.;.;.;.;.;.;.;.;.;.;.;.;.;.;.;.;.;.;.;.;.;.;.;.;.;.;.;.;.;.;.;.;.;.;.;.;.;.;.;.;.;.;.;.;.;.;.;.
.;.;.;.;.;.;.;.;.;.;.;.;.;.;.;.;.;.;.;.;.;.;.;.;.;.;.;.;.;.;.;.;.;.;.;.;.;.;.;.;.;.;.;.;.;.;.;.;.;.;.;.;.;.;.;.;.;.;.;.;.;.;.;.
.;.;r;r;r;r;r;r;r;r;r;.;t;t;t;t;t;t;t;t;t;.;j;j;j;j;j;j;j;j;j;.;f;f;f;f;f;f;f;f;f;.;l;l;l;l;l;l;l;l;l;.;k;k;k;k;k;k;k;k;k;.;.;.
.;.;r;r;r;r;r;r;r;r;r;.;t;t;t;t;t;t;t;t;t;.;j;j;j;j;j;j;j;j;j;.;f;f;f;f;f;f;f;f;f;.;l;l;l;l;l;l;l;l;l;.;k;k;k;k;k;k;k;k;k;.;.;.
.;.;r;r;r;r;r;r;r;r;r;.;t;t;t;t;t;t;t;t;t;.;j;j;j;j;j;j;j;j;j;.;f;f;f;f;f;f;f;f;f;.;l;l;l;l;l;l;l;l;l;.;k;k;k;k;k;k;k;k;k;.;.;.
.;.;r;r;r;r;r;r;r;r;r;.;t;t;t;t;t;t;t;t;t;.;j;j;j;j;j;j;j;j;j;.;f;f;f;f;f;f;f;f;f;.;l;l;l;l;l;l;l;l;l;.;k;k;k;k;k;k;k;k;k;.;.;.
.;.;r;r;r;r;r;r;r;r;r;.;t;t;t;t;t;t;t;t;t;.;j;j;j;j;j;j;j;j;j;.;f;f;f;f;f;f;f;f;f;.;l;l;l;l;l;l;l;l;l;.;k;k;k;k;k;k;k;k;k;.;.;.
.;.;r;r;r;r;r;r;r;r;r;.;t;t;t;t;t;t;t;t;t;.;j;j;j;j;j;j;j;j;j;.;f;f;f;f;f;f;f;f;f;.;l;l;l;l;l;l;l;l;l;.;k;k;k;k;k;k;k;k;k;.;.;.
.;.;r;r;r;r;r;r;r;r;r;.;t;t;t;t;t;t;t;t;t;.;j;j;j;j;j;j;j;j;j;.;f;f;f;f;f;f;f;f;f;.;l;l;l;l;l;l;l;l;l;.;k;k;k;k;k;k;k;k;k;.;.;.
.;.;r;r;r;r;r;r;r;r;r;.;t;t;t;t;t;t;t;t;t;.;j;j;j;j;j;j;j;j;j;.;f;f;f;f;f;f;f;f;f;.;l;l;l;l;l;l;l;l;l;.;k;k;k;k;k;k;k;k;k;.;.;.
.;.;.;.;.;.;.;.;.;.;.;.;.;.;.;.;.;.;.;.;.;.;.;.;.;.;.;.;.;.;.;.;.;.;.;.;.;.;.;.;.;.;.;.;.;.;.;.;.;.;.;.;.;.;.;.;.;.;.;.;.;.;.;.
.;.;.;.;.;.;.;.;.;.;.;.;.;.;.;.;.;.;.;.;.;.;.;.;.;.;.;.;.;.;.;.;.;.;.;.;.;.;.;.;.;.;.;.;.;.;.;.;.;.;.;.;.;.;.;.;.;.;.;.;.;.;.;.
.;.;y;y;y;y;y;y;y;y;y;.;z;z;z;z;z;z;z;z;z;.;0;0;0;0;0;0;0;0;0;.;1;1;1;1;1;1;1;1;1;.;7;7;7;7;7;7;7;7;7;.;3;3;3;3;3;3;3;3;3;.;.;.
.;.;y;y;y;y;y;y;y;y;y;.;z;z;z;z;z;z;z;z;z;.;0;0;0;0;0;0;0;0;0;.;1;1;1;1;1;1;1;1;1;.;7;7;7;7;7;7;7;7;7;.;3;3;3;3;3;3;3;3;3;.;.;.
.;.;y;y;y;y;y;y;y;y;y;.;z;z;z;z;z;z;z;z;z;.;0;0;0;0;0;0;0;0;0;.;1;1;1;1;1;1;1;1;1;.;7;7;7;7;7;7;7;7;7;.;3;3;3;3;3;3;3;3;3;.;.;.
.;.;y;y;y;y;y;y;y;y;y;.;z;z;z;z;z;z;z;z;z;.;0;0;0;0;0;0;0;0;0;.;1;1;1;1;1;1;1;1;1;.;7;7;7;7;7;7;7;7;7;.;3;3;3;3;3;3;3;3;3;.;.;.
.;.;y;y;y;y;y;y;y;y;y;.;z;z;z;z;z;z;z;z;z;.;0;0;0;0;0;0;0;0;0;.;1;1;1;1;1;1;1;1;1;.;7;7;7;7;7;7;7;7;7;.;3;3;3;3;3;3;3;3;3;.;.;.
.;.;y;y;y;y;y;y;y;y;y;.;z;z;z;z;z;z;z;z;z;.;0;0;0;0;0;0;0;0;0;.;1;1;1;1;1;1;1;1;1;.;7;7;7;7;7;7;7;7;7;.;3;3;3;3;3;3;3;3;3;.;.;.
.;.;y;y;y;y;y;y;y;y;y;.;z;z;z;z;z;z;z;z;z;.;0;0;0;0;0;0;0;0;0;.;1;1;1;1;1;1;1;1;1;.;7;7;7;7;7;7;7;7;7;.;3;3;3;3;3;3;3;3;3;.;.;.
.;.;y;y;y;y;y;y;y;y;y;.;z;z;z;z;z;z;z;z;z;.;0;0;0;0;0;0;0;0;0;.;1;1;1;1;1;1;1;1;1;.;7;7;7;7;7;7;7;7;7;.;3;3;3;3;3;3;3;3;3;.;.;.
.;.;.;.;.;.;.;.;.;.;.;.;.;.;.;.;.;.;.;.;.;.;.;.;.;.;.;.;.;.;.;.;.;.;.;.;.;.;.;.;.;.;.;.;.;.;.;.;.;.;.;.;.;.;.;.;.;.;.;.;.;.;.;.
.;.;.;.;.;.;.;.;.;.;.;.;.;.;.;.;.;.;.;.;.;.;.;.;.;.;.;.;.;.;.;.;.;.;.;.;.;.;.;.;.;.;.;.;.;.;.;.;.;.;.;.;.;.;.;.;.;.;.;.;.;.;.;.
.;.;4;4;4;4;4;4;4;4;4;.;5;5;5;5;5;5;5;5;5;.;6;6;6;6;6;6;6;6;6;.;2;2;2;2;2;2;2;2;2;.;8;8;8;8;8;8;8;8;8;.;9;9;9;9;9;9;9;9;9;.;.;.
.;.;4;4;4;4;4;4;4;4;4;.;5;5;5;5;5;5;5;5;5;.;6;6;6;6;6;6;6;6;6;.;2;2;2;2;2;2;2;2;2;.;8;8;8;8;8;8;8;8;8;.;9;9;9;9;9;9;9;9;9;.;.;.
.;.;4;4;4;4;4;4;4;4;4;.;5;5;5;5;5;5;5;5;5;.;6;6;6;6;6;6;6;6;6;.;2;2;2;2;2;2;2;2;2;.;8;8;8;8;8;8;8;8;8;.;9;9;9;9;9;9;9;9;9;.;.;.
.;.;4;4;4;4;4;4;4;4;4;.;5;5;5;5;5;5;5;5;5;.;6;6;6;6;6;6;6;6;6;.;2;2;2;2;2;2;2;2;2;.;8;8;8;8;8;8;8;8;8;.;9;9;9;9;9;9;9;9;9;.;.;.
.;.;4;4;4;4;4;4;4;4;4;.;5;5;5;5;5;5;5;5;5;.;6;6;6;6;6;6;6;6;6;.;2;2;2;2;2;2;2;2;2;.;8;8;8;8;8;8;8;8;8;.;9;9;9;9;9;9;9;9;9;.;.;.
.;.;4;4;4;4;4;4;4;4;4;.;5;5;5;5;5;5;5;5;5;.;6;6;6;6;6;6;6;6;6;.;2;2;2;2;2;2;2;2;2;.;8;8;8;8;8;8;8;8;8;.;9;9;9;9;9;9;9;9;9;.;.;.
.;.;4;4;4;4;4;4;4;4;4;.;5;5;5;5;5;5;5;5;5;.;6;6;6;6;6;6;6;6;6;.;2;2;2;2;2;2;2;2;2;.;8;8;8;8;8;8;8;8;8;.;9;9;9;9;9;9;9;9;9;.;.;.
.;.;4;4;4;4;4;4;4;4;4;.;5;5;5;5;5;5;5;5;5;.;6;6;6;6;6;6;6;6;6;.;2;2;2;2;2;2;2;2;2;.;8;8;8;8;8;8;8;8;8;.;9;9;9;9;9;9;9;9;9;.;.;.
.;.;.;.;.;.;.;.;.;.;.;.;.;.;.;.;.;.;.;.;.;.;.;.;.;.;.;.;.;.;.;.;.;.;.;.;.;.;.;.;.;.;.;.;.;.;.;.;.;.;.;.;.;.;.;.;.;.;.;.;.;.;.;.
.;.;.;.;.;.;.;.;.;.;.;.;.;.;.;.;.;.;.;.;.;.;.;.;.;.;.;.;.;.;.;.;.;.;.;.;.;.;.;.;.;.;.;.;.;.;.;.;.;.;.;.;.;.;.;.;.;.;.;.;.;.;.;.
.;.;.;.;.;.;.;.;.;.;.;.;.;.;.;.;.;.;.;.;.;.;.;.;.;.;.;.;.;.;.;.;.;.;.;.;.;.;.;.;.;.;.;.;.;.;.;.;.;.;.;.;.;.;.;.;.;.;.;.;.;.;.;.
