a;a;a;a;a;a;a;a;a;a;a;a;a;.;.;.;.;.;.;.;.;.;.;.;.;.;.;.;.;.;.;.;.;.;.;.;.;.;.;.;.;.;.;.;.;.;.;.;.;.;.;h;h;h;h;h;h;h;h;h;h;h;h;h
a;a;a;a;a;a;a;a;a;a;a;a;a;.;.;.;b;b;b;b;b;b;b;b;.;0;0;0;0;0;0;0;0;0;0;0;0;0;0;.;c;c;c;c;c;c;c;c;.;.;.;h;h;h;h;h;h;h;h;h;h;h;h;h
a;a;a;a;a;a;a;a;a;a;a;a;a;.;.;.;b;b;b;b;b;b;b;b;.;0;0;0;0;0;0;0;0;0;0;0;0;0;0;.;c;c;c;c;c;c;c;c;.;.;.;h;h;h;h;h;h;h;h;h;h;h;h;h
a;a;a;a;a;a;a;a;a;a;a;a;a;.;.;.;b;b;b;b;b;b;b;b;.;0;0;.;.;.;.;.;.;.;.;.;.;0;0;.;c;c;c;c;c;c;c;c;.;.;.;h;h;h;h;h;h;h;h;h;h;h;h;h
a;a;a;a;a;a;a;a;a;a;a;a;a;.;.;.;b;b;b;b;b;b;b;b;.;0;0;.;z;z;z;z;z;z;z;z;.;0;0;.;c;c;c;c;c;c;c;c;.;.;.;h;h;h;h;h;h;h;h;h;h;h;h;h
a;a;a;a;a;a;a;a;a;a;a;a;a;.;.;.;b;b;b;b;b;b;b;b;.;0;0;.;z;z;z;z;z;z;z;z;.;0;0;.;c;c;c;c;c;c;c;c;.;.;.;h;h;h;h;h;h;h;h;h;h;h;h;h
a;a;a;a;a;a;a;a;a;a;a;a;a;.;.;.;b;b;b;b;b;b;b;b;.;0;0;.;z;z;z;z;z;z;z;z;.;0;0;.;c;c;c;c;c;c;c;c;.;.;.;h;h;h;h;h;h;h;h;h;h;h;h;h
a;a;a;a;a;a;a;a;a;a;a;a;a;.;.;.;b;b;b;b;b;b;b;b;.;0;0;.;z;z;z;z;z;z;z;z;.;0;0;.;c;c;c;c;c;c;c;c;.;.;.;h;h;h;h;h;h;h;h;h;h;h;h;h
a;a;a;a;a;a;a;a;a;a;.;.;.;.;.;.;b;b;b;b;b;b;b;b;.;0;0;.;z;z;z;z;z;z;z;z;.;0;0;.;c;c;c;c;c;c;c;c;.;.;.;.;.;.;h;h;h;h;h;h;h;h;h;h
a;a;a;a;a;a;a;a;a;a;.;.;.;.;.;.;b;b;b;b;b;b;b;b;.;0;0;.;z;z;z;z;z;z;z;z;.;0;0;.;c;c;c;c;c;c;c;c;.;.;.;.;.;.;h;h;h;h;h;h;h;h;h;h
a;a;a;a;a;a;a;a;a;a;.;.;.;.;.;.;b;b;b;b;b;b;b;b;.;0;0;.;z;z;z;z;z;z;z;z;.;0;0;.;c;c;c;c;c;c;c;c;.;.;.;.;.;.;h;h;h;h;h;h;h;h;h;h
a;a;a;a;a;a;a;a;a;a;.;.;.;.;.;.;b;b;b;b;b;b;b;b;.;0;0;.;z;z;z;z;z;z;z;z;.;0;0;.;c;c;c;c;c;c;c;c;.;.;.;.;.;.;h;h;h;h;h;h;h;h;h;h
a;a;a;a;a;.;.;.;.;.;.;.;.;.;.;.;b;b;b;b;b;b;b;b;.;0;0;.;z;z;z;z;z;z;z;z;.;0;0;.;c;c;c;c;c;c;c;c;.;.;.;.;.;.;.;.;.;.;.;.;h;h;h;h
a;a;a;a;a;.;.;.;.;.;.;.;.;.;.;.;b;b;b;b;b;b;b;b;.;0;0;.;z;z;z;z;z;z;z;z;.;0;0;.;c;c;c;c;c;c;c;c;.;.;.;.;.;.;.;.;.;.;.;.;h;h;h;h
a;a;a;a;a;.;.;.;.;.;.;.;.;.;.;.;b;b;b;b;b;b;b;b;.;0;0;.;z;z;z;z;z;z;z;z;.;0;0;.;c;c;c;c;c;c;c;c;.;.;.;.;.;.;.;.;.;.;.;.;h;h;h;h
a;a;a;a;a;a;a;a;a;a;a;a;.;.;b;b;b;b;b;b;b;b;b;b;.;0;0;.;z;z;z;z;z;z;z;z;.;0;0;.;c;c;c;c;c;c;c;c;c;c;.;.;h;h;h;h;h;h;h;h;h;h;h;h
a;a;a;a;a;a;a;a;a;a;a;a;.;.;b;b;b;b;b;b;b;b;b;b;.;0;0;.;z;z;z;z;z;z;z;z;.;0;0;.;c;c;c;c;c;c;c;c;c;c;.;.;h;h;h;h;h;h;h;h;h;h;h;h
a;a;a;a;a;a;a;a;a;a;a;a;.;.;b;b;b;b;b;b;b;b;b;b;.;0;0;.;z;z;z;z;z;z;z;z;.;0;0;.;c;c;c;c;c;c;c;c;c;c;.;.;h;h;h;h;h;h;h;h;h;h;h;h
a;a;a;a;a;a;a;a;a;a;a;a;.;.;b;b;b;b;b;b;b;b;b;b;.;0;0;.;z;z;z;z;z;z;z;z;.;0;0;.;c;c;c;c;c;c;c;c;c;c;.;.;h;h;h;h;h;h;h;h;h;h;h;h
a;a;a;a;a;a;a;a;a;a;a;a;.;.;b;b;b;b;b;b;b;b;b;b;.;0;0;.;.;.;.;.;.;.;.;.;.;0;0;.;c;c;c;c;c;c;c;c;c;c;.;.;h;h;h;h;h;h;h;h;h;h;h;h
a;a;a;a;a;a;a;a;a;a;a;a;.;.;b;b;b;b;b;b;b;b;b;b;.;0;0;0;0;0;0;0;0;0;0;0;0;0;0;.;c;c;c;c;c;c;c;c;c;c;.;.;h;h;h;h;h;h;h;h;h;h;h;h
a;a;a;a;a;a;a;a;a;a;a;a;.;.;b;b;b;b;b;b;b;b;b;b;.;0;0;0;0;0;0;0;0;0;0;0;0;0;0;.;c;c;c;c;c;c;c;c;c;c;.;.;h;h;h;h;h;h;h;h;h;h;h;h
.;.;.;.;.;.;.;.;.;.;.;.;.;.;.;.;.;.;.;.;.;.;.;.;.;.;.;.;.;.;.;.;.;.;.;.;.;.;.;.;.;.;.;.;.;.;.;.;.;.;.;.;.;.;.;.;.;.;.;.;.;.;.;.
.;.;.;.;.;.;.;.;.;.;.;.;.;.;.;.;.;.;.;.;.;.;.;.;.;.;.;.;.;.;.;.;.;.;.;.;.;.;.;.;.;.;.;.;.;.;.;.;.;.;.;.;.;.;.;.;.;.;.;.;.;.;.;.
.;.;.;.;.;.;.;.;.;.;.;.;.;.;j;j;j;j;j;j;j;j;j;j;j;j;j;j;j;j;j;j;j;j;j;j;j;j;.;.;.;o;o;o;o;o;o;o;o;o;.;.;.;.;.;.;.;.;.;.;.;.;.;.
.;.;.;.;.;.;.;.;.;.;.;.;.;.;j;j;j;j;j;j;j;j;j;j;j;j;j;j;j;j;j;j;j;j;j;j;j;j;.;.;.;o;o;o;o;o;o;o;o;o;.;.;.;.;.;.;.;.;.;.;.;.;.;.
i;i;i;i;i;i;i;i;i;i;i;i;.;.;j;j;j;j;j;j;j;j;j;j;j;j;j;j;j;j;j;j;j;j;j;j;j;j;.;.;.;o;o;o;o;o;o;o;o;o;.;.;t;t;t;t;t;t;t;t;t;t;t;t
i;i;i;i;i;i;i;i;i;i;i;i;.;.;j;j;j;j;j;j;j;j;j;j;j;j;j;j;j;j;j;j;j;j;j;j;j;j;.;.;.;o;o;o;o;o;o;o;o;o;.;.;t;t;t;t;t;t;t;t;t;t;t;t
i;i;i;i;i;i;i;i;i;i;i;i;.;.;j;j;j;j;j;j;j;j;j;.;.;.;j;j;j;j;j;j;j;j;j;j;j;j;.;.;.;o;o;o;o;o;o;o;o;o;.;.;t;t;t;t;t;t;t;t;t;t;t;t
i;i;i;i;i;i;i;i;i;i;i;i;.;.;j;j;j;j;j;j;j;j;j;.;.;.;j;j;j;j;j;j;j;j;j;j;j;j;.;.;.;o;o;o;o;o;o;o;o;o;.;.;t;t;t;t;t;t;t;t;t;t;t;t
i;i;i;i;i;i;i;i;i;i;i;i;.;.;j;j;j;j;j;j;j;j;j;.;.;.;j;j;j;j;j;j;j;j;j;j;j;j;.;.;.;o;o;o;o;o;o;o;o;o;.;.;t;t;t;t;t;t;t;t;t;t;t;t
i;i;i;i;i;i;i;i;i;.;.;.;.;.;j;j;j;j;j;j;j;j;j;.;.;.;j;j;j;j;j;j;j;j;j;j;j;j;.;.;.;o;o;o;o;o;o;o;o;o;.;.;.;.;.;t;t;t;t;t;t;t;t;t
i;i;i;i;i;i;i;i;i;.;.;.;.;.;j;j;j;j;j;j;j;j;j;.;.;.;.;.;.;.;.;.;.;.;.;.;.;.;.;.;.;o;o;o;o;o;o;o;o;o;.;.;.;.;.;t;t;t;t;t;t;t;t;t
i;i;i;i;i;i;i;i;i;.;.;j;j;j;j;j;j;j;j;j;j;j;j;.;.;.;o;o;o;o;o;o;o;o;o;o;o;o;.;.;.;o;o;o;o;o;o;o;o;o;o;o;o;.;.;t;t;t;t;t;t;t;t;t
i;i;i;i;i;i;i;i;i;.;.;j;j;j;j;j;j;j;j;j;j;j;j;.;.;.;o;o;o;o;o;o;o;o;o;o;o;o;.;.;.;o;o;o;o;o;o;o;o;o;o;o;o;.;.;t;t;t;t;t;t;t;t;t
i;i;i;i;i;i;i;i;i;.;.;j;j;j;j;j;j;j;j;j;j;j;j;.;.;.;o;o;o;o;o;o;o;o;o;o;o;o;.;.;.;o;o;o;o;o;o;o;o;o;o;o;o;.;.;t;t;t;t;t;t;t;t;t
i;i;i;i;i;i;i;i;i;.;.;j;j;j;j;j;j;j;j;j;j;j;j;.;.;.;o;o;o;o;o;o;o;o;o;o;o;o;o;o;o;o;o;o;o;o;o;o;o;o;o;o;o;.;.;t;t;t;t;t;t;t;t;t
i;i;i;i;i;i;i;i;i;.;.;j;j;j;j;j;j;j;j;j;j;j;j;.;.;.;o;o;o;o;o;o;o;o;o;o;o;o;o;o;o;o;o;o;o;o;o;o;o;o;o;o;o;.;.;t;t;t;t;t;t;t;t;t
i;i;i;i;i;i;i;i;i;.;.;j;j;j;j;j;j;j;j;j;j;j;j;.;.;.;o;o;o;o;o;o;o;o;o;o;o;o;o;o;o;o;o;o;o;o;o;o;o;o;o;o;o;.;.;t;t;t;t;t;t;t;t;t
i;i;i;i;i;i;i;i;i;.;.;j;j;j;j;j;j;j;j;j;j;j;j;.;.;.;o;o;o;o;o;o;o;o;o;o;o;o;o;o;o;o;o;o;o;o;o;o;o;o;o;o;o;.;.;t;t;t;t;t;t;t;t;t
i;i;i;i;i;i;i;i;i;.;.;.;.;.;.;.;.;.;.;.;.;.;.;.;.;.;.;.;.;.;.;.;.;.;.;.;.;.;.;.;.;.;.;.;.;.;.;.;.;.;.;.;.;.;.;t;t;t;t;t;t;t;t;t
i;i;i;i;i;i;i;i;i;.;.;.;.;.;.;.;.;.;.;.;.;.;.;.;.;1;1;1;1;1;1;1;1;1;1;1;1;1;1;.;.;.;.;.;.;.;.;.;.;.;.;.;.;.;.;t;t;t;t;t;t;t;t;t
i;i;i;i;i;i;i;i;i;i;i;i;.;.;v;v;v;v;v;v;v;v;v;v;.;1;1;1;1;1;1;1;1;1;1;1;1;1;1;.;w;w;w;w;w;w;w;w;w;w;.;.;t;t;t;t;t;t;t;t;t;t;t;t
i;i;i;i;i;i;i;i;i;i;i;i;.;.;v;v;v;v;v;v;v;v;v;v;.;1;1;.;.;.;.;.;.;.;.;.;.;1;1;.;w;w;w;w;w;w;w;w;w;w;.;.;t;t;t;t;t;t;t;t;t;t;t;t
i;i;i;i;i;i;i;i;i;i;i;i;.;.;v;v;v;v;v;v;v;v;v;v;.;1;1;.;y;y;y;y;y;y;y;y;.;1;1;.;w;w;w;w;w;w;w;w;w;w;.;.;t;t;t;t;t;t;t;t;t;t;t;t
i;i;i;i;i;i;i;i;i;i;i;i;.;.;v;v;v;v;v;v;v;v;v;v;.;1;1;.;y;y;y;y;y;y;y;y;.;1;1;.;w;w;w;w;w;w;w;w;w;w;.;.;t;t;t;t;t;t;t;t;t;t;t;t
i;i;i;i;i;i;i;i;i;i;i;i;.;.;v;v;v;v;v;v;v;v;v;v;.;1;1;.;y;y;y;y;y;y;y;y;.;1;1;.;w;w;w;w;w;w;w;w;w;w;.;.;t;t;t;t;t;t;t;t;t;t;t;t
i;i;i;i;i;i;i;i;i;i;i;i;.;.;v;v;v;v;v;v;v;v;v;v;.;1;1;.;y;y;y;y;y;y;y;y;.;1;1;.;w;w;w;w;w;w;w;w;w;w;.;.;t;t;t;t;t;t;t;t;t;t;t;t
i;i;i;i;i;i;i;i;i;i;i;i;.;.;v;v;v;v;v;v;v;v;v;v;.;1;1;.;y;y;y;y;y;y;y;y;.;1;1;.;w;w;w;w;w;w;w;w;w;w;.;.;t;t;t;t;t;t;t;t;t;t;t;t
.;.;.;.;.;.;.;.;.;.;.;.;.;.;.;.;.;.;.;.;v;v;v;v;.;1;1;.;y;y;y;y;y;y;y;y;.;1;1;.;w;w;w;w;.;.;.;.;.;.;.;.;.;.;.;.;.;.;.;.;.;.;.;.
.;.;.;.;.;.;.;.;.;.;.;.;.;.;.;.;.;.;.;.;v;v;v;v;.;1;1;.;y;y;y;y;y;y;y;y;.;1;1;.;w;w;w;w;.;.;.;.;.;.;.;.;.;.;.;.;.;.;.;.;.;.;.;.
.;.;.;.;.;.;.;.;.;.;.;.;.;.;.;.;.;.;.;.;v;v;v;v;.;1;1;.;y;y;y;y;y;y;y;y;.;1;1;.;w;w;w;w;.;.;.;.;.;.;.;.;.;.;.;.;.;.;.;.;.;.;.;.
u;u;u;u;u;u;u;u;u;u;.;.;.;.;.;.;.;.;.;.;v;v;v;v;.;1;1;.;y;y;y;y;y;y;y;y;.;1;1;.;w;w;w;w;.;.;.;.;.;.;.;.;.;.;x;x;x;x;x;x;x;x;x;x
u;u;u;u;u;u;u;u;u;u;.;.;.;.;.;.;.;.;.;.;v;v;v;v;.;1;1;.;y;y;y;y;y;y;y;y;.;1;1;.;w;w;w;w;.;.;.;.;.;.;.;.;.;.;x;x;x;x;x;x;x;x;x;x
u;u;u;u;u;u;u;u;u;u;.;.;.;.;.;.;.;.;.;.;v;v;v;v;.;1;1;.;y;y;y;y;y;y;y;y;.;1;1;.;w;w;w;w;.;.;.;.;.;.;.;.;.;.;x;x;x;x;x;x;x;x;x;x
u;u;u;u;u;u;u;u;u;u;.;.;.;.;.;.;.;.;.;.;v;v;v;v;.;1;1;.;y;y;y;y;y;y;y;y;.;1;1;.;w;w;w;w;.;.;.;.;.;.;.;.;.;.;x;x;x;x;x;x;x;x;x;x
u;u;u;u;u;u;u;u;u;u;u;u;u;.;.;.;v;v;v;v;v;v;v;v;.;1;1;.;y;y;y;y;y;y;y;y;.;1;1;.;w;w;w;w;w;w;w;w;.;.;.;x;x;x;x;x;x;x;x;x;x;x;x;x
u;u;u;u;u;u;u;u;u;u;u;u;u;.;.;.;v;v;v;v;v;v;v;v;.;1;1;.;y;y;y;y;y;y;y;y;.;1;1;.;w;w;w;w;w;w;w;w;.;.;.;x;x;x;x;x;x;x;x;x;x;x;x;x
u;u;u;u;u;u;u;u;u;u;u;u;u;.;.;.;v;v;v;v;v;v;v;v;.;1;1;.;y;y;y;y;y;y;y;y;.;1;1;.;w;w;w;w;w;w;w;w;.;.;.;x;x;x;x;x;x;x;x;x;x;x;x;x
u;u;u;u;u;u;u;u;u;u;u;u;u;.;.;.;v;v;v;v;v;v;v;v;.;1;1;.;y;y;y;y;y;y;y;y;.;1;1;.;w;w;w;w;w;w;w;w;.;.;.;x;x;x;x;x;x;x;x;x;x;x;x;x
u;u;u;u;u;u;u;u;u;u;u;u;u;.;.;.;v;v;v;v;v;v;v;v;.;1;1;.;.;.;.;.;.;.;.;.;.;1;1;.;w;w;w;w;w;w;w;w;.;.;.;x;x;x;x;x;x;x;x;x;x;x;x;x
u;u;u;u;u;u;u;u;u;u;u;u;u;.;.;.;v;v;v;v;v;v;v;v;.;1;1;1;1;1;1;1;1;1;1;1;1;1;1;.;w;w;w;w;w;w;w;w;.;.;.;x;x;x;x;x;x;x;x;x;x;x;x;x
u;u;u;u;u;u;u;u;u;u;u;u;u;.;.;.;v;v;v;v;v;v;v;v;.;1;1;1;1;1;1;1;1;1;1;1;1;1;1;.;w;w;w;w;w;w;w;w;.;.;.;x;x;x;x;x;x;x;x;x;x;x;x;x
u;u;u;u;u;u;u;u;u;u;u;u;u;.;.;.;.;.;.;.;.;.;.;.;.;.;.;.;.;.;.;.;.;.;.;.;.;.;.;.;.;.;.;.;.;.;.;.;.;.;.;x;x;x;x;x;x;x;x;x;x;x;x;x
