q;d;q;d;q;d;q;d;q;d;q;d;q;d;q;d;q;d;q;d;q;q;d;q;d;q;d;q;d;q;d;q;d;q;d;q;d;q;d;q;d;q;q;d;q;d;q;d;q;d;q;d;q;d;q;d;q;d;q;d;q;d;q;d
d;.;.;.;.;.;.;.;.;.;.;.;.;.;.;.;.;.;.;.;.;.;.;.;.;.;.;.;.;.;.;.;.;.;.;.;.;.;.;.;.;.;.;.;.;.;.;.;.;.;.;.;.;.;.;.;.;.;.;.;.;.;.;q
q;.;q;q;q;q;q;q;q;q;q;q;q;q;q;q;q;.;.;d;d;d;d;d;d;d;d;d;d;d;.;.;.;.;q;q;q;q;q;q;q;q;q;q;q;q;.;.;d;d;d;d;d;d;d;d;d;d;d;d;d;d;.;d
d;.;q;q;q;q;q;q;q;q;q;q;q;q;q;q;q;.;.;d;d;d;d;d;d;d;d;d;d;d;.;.;.;.;q;q;q;q;q;q;q;q;q;q;q;q;.;.;d;d;d;d;d;d;d;d;d;d;d;d;d;d;.;q
q;.;q;q;q;q;q;q;q;q;q;q;q;q;q;q;q;.;.;d;d;d;d;d;d;d;d;d;d;d;.;.;.;.;q;q;q;q;q;q;q;q;q;q;q;q;.;.;d;d;d;d;d;d;d;d;d;d;d;d;d;d;.;d
d;.;q;q;q;q;q;q;q;q;q;q;q;q;q;q;q;.;.;d;d;d;d;d;d;d;d;d;d;d;.;.;.;.;q;q;q;q;q;q;q;q;q;q;q;q;.;.;d;d;d;d;d;d;d;d;d;d;d;d;d;d;.;q
q;.;q;q;q;q;q;q;q;q;q;q;q;q;q;q;q;.;.;d;d;d;d;d;d;d;d;d;d;d;.;.;.;.;q;q;q;q;q;q;q;q;q;q;q;q;.;.;d;d;d;d;d;d;d;d;d;d;d;d;d;d;.;d
d;.;q;q;q;q;q;q;q;q;q;q;q;q;q;q;q;.;.;d;d;d;d;d;d;d;d;d;d;d;.;.;.;.;q;q;q;q;q;q;q;q;q;q;q;q;.;.;d;d;d;d;d;d;d;d;d;d;d;d;d;d;.;q
q;.;q;q;q;q;q;q;q;q;q;q;q;q;q;q;q;.;.;d;d;d;d;d;d;d;d;d;d;d;.;.;.;.;q;q;q;q;q;q;q;q;q;q;q;q;.;.;d;d;d;d;d;d;d;d;d;d;d;d;d;d;.;d
d;.;q;q;q;q;q;q;q;q;q;q;q;q;q;q;q;.;.;d;d;d;d;d;d;d;d;d;d;d;.;.;.;.;q;q;q;q;q;q;q;q;q;q;q;q;.;.;d;d;d;d;d;d;d;d;d;d;d;d;d;d;.;q
q;.;q;q;q;q;q;q;q;q;q;q;q;q;q;q;q;.;.;d;d;d;d;d;d;d;d;d;d;d;.;.;.;.;q;q;q;q;q;q;q;q;q;q;q;q;.;.;d;d;d;d;d;d;d;d;d;d;d;d;d;d;.;d
d;.;q;q;q;q;q;q;q;q;q;q;q;q;q;q;q;.;.;d;d;d;d;d;d;d;d;d;d;d;.;.;.;.;q;q;q;q;q;q;q;q;q;q;q;q;.;.;d;d;d;d;d;d;d;d;d;d;d;d;d;d;.;q
q;.;q;q;q;q;q;q;q;q;q;q;q;q;q;q;q;.;.;d;d;d;d;d;d;d;d;d;d;d;.;.;.;.;q;q;q;q;q;q;q;q;q;q;q;q;.;.;d;d;d;d;d;d;d;d;d;d;d;d;d;d;.;d
d;.;q;q;q;q;q;q;q;q;q;q;q;q;q;q;q;.;.;d;d;d;d;d;d;d;d;d;d;d;.;.;.;.;q;q;q;q;q;q;q;q;q;q;q;q;.;.;d;d;d;d;d;d;d;d;d;d;d;d;d;d;.;q
q;.;q;q;q;q;q;q;q;q;q;q;q;q;q;q;q;.;.;d;d;d;d;d;d;d;d;d;d;d;.;.;.;.;q;q;q;q;q;q;q;q;q;q;q;q;.;.;d;d;d;d;d;d;d;d;d;d;d;d;d;d;.;d
d;.;q;q;q;q;q;q;q;q;q;q;q;q;q;q;q;.;.;d;d;d;d;d;d;d;d;d;d;d;.;.;.;.;q;q;q;q;q;q;q;q;q;q;q;q;.;.;d;d;d;d;d;d;d;d;d;d;d;d;d;d;.;q
q;.;.;.;.;.;.;.;.;.;.;.;.;.;.;.;.;.;.;.;.;.;.;.;.;.;.;.;.;.;.;.;.;.;.;.;.;.;.;.;.;.;.;.;.;.;.;.;.;.;.;.;.;.;.;.;.;.;.;.;.;.;.;d
d;.;.;.;.;.;.;.;.;.;.;.;.;.;.;.;.;.;.;.;.;.;.;.;.;.;.;.;.;.;.;.;.;.;.;.;.;.;.;.;.;.;.;.;.;.;.;.;.;.;.;.;.;.;.;.;.;.;.;.;.;.;.;q
q;.;.;.;.;.;.;.;.;.;.;.;.;.;.;.;.;.;.;.;.;.;.;.;.;.;.;.;.;.;.;.;.;.;.;.;.;.;.;.;.;.;.;.;.;.;.;.;.;.;.;.;.;.;.;.;.;.;.;.;.;.;.;d
d;.;d;d;d;d;d;d;d;d;d;d;d;d;d;d;d;.;.;q;q;q;q;q;q;q;q;q;q;q;.;.;.;.;d;d;d;d;d;d;d;d;d;d;d;d;.;.;q;q;q;q;q;q;q;q;q;q;q;q;q;q;.;q
q;.;d;d;d;d;d;d;d;d;d;d;d;d;d;d;d;.;.;q;q;q;q;q;q;q;q;q;q;q;.;.;.;.;d;d;d;d;d;d;d;d;d;d;d;d;.;.;q;q;q;q;q;q;q;q;q;q;q;q;q;q;.;d
d;.;d;d;d;d;d;d;d;d;d;d;d;d;d;d;d;.;.;q;q;q;q;q;q;q;q;q;q;q;.;.;.;.;d;d;d;d;d;d;d;d;d;d;d;d;.;.;q;q;q;q;q;q;q;q;q;q;q;q;q;q;.;q
q;.;d;d;d;d;d;d;d;d;d;d;d;d;d;d;d;.;.;q;q;q;q;q;q;q;q;q;q;q;.;.;.;.;d;d;d;d;d;d;d;d;d;d;d;d;.;.;q;q;q;q;q;q;q;q;q;q;q;q;q;q;.;d
d;.;d;d;d;d;d;d;d;d;d;d;d;d;d;d;d;.;.;q;q;q;q;q;q;q;q;q;q;q;.;.;.;.;d;d;d;d;d;d;d;d;d;d;d;d;.;.;q;q;q;q;q;q;q;q;q;q;q;q;q;q;.;q
q;.;d;d;d;d;d;d;d;d;d;d;d;d;d;d;d;.;.;q;q;q;q;q;q;q;q;q;q;q;.;.;.;.;d;d;d;d;d;d;d;d;d;d;d;d;.;.;q;q;q;q;q;q;q;q;q;q;q;q;q;q;.;d
d;.;d;d;d;d;d;d;d;d;d;d;d;d;d;d;d;.;.;q;q;q;q;q;q;q;q;q;q;q;.;.;.;.;d;d;d;d;d;d;d;d;d;d;d;d;.;.;q;q;q;q;q;q;q;q;q;q;q;q;q;q;.;q
q;.;d;d;d;d;d;d;d;d;d;d;d;d;d;d;d;.;.;q;q;q;q;q;q;q;q;q;q;q;.;.;.;.;d;d;d;d;d;d;d;d;d;d;d;d;.;.;q;q;q;q;q;q;q;q;q;q;q;q;q;q;.;d
d;.;d;d;d;d;d;d;d;d;d;d;d;d;d;d;d;.;.;q;q;q;q;q;q;q;q;q;q;q;.;.;.;.;d;d;d;d;d;d;d;d;d;d;d;d;.;.;q;q;q;q;q;q;q;q;q;q;q;q;q;q;.;q
q;.;d;d;d;d;d;d;d;d;d;d;d;d;d;d;d;.;.;q;q;q;q;q;q;q;q;q;q;q;.;.;.;.;d;d;d;d;d;d;d;d;d;d;d;d;.;.;q;q;q;q;q;q;q;q;q;q;q;q;q;q;.;d
d;.;d;d;d;d;d;d;d;d;d;d;d;d;d;d;d;.;.;q;q;q;q;q;q;q;q;q;q;q;.;.;.;.;d;d;d;d;d;d;d;d;d;d;d;d;.;.;q;q;q;q;q;q;q;q;q;q;q;q;q;q;.;q
q;.;d;d;d;d;d;d;d;d;d;d;d;d;d;d;d;.;.;q;q;q;q;q;q;q;q;q;q;q;.;.;.;.;d;d;d;d;d;d;d;d;d;d;d;d;.;.;q;q;q;q;q;q;q;q;q;q;q;q;q;q;.;d
d;.;.;.;.;.;.;.;.;.;.;.;.;.;.;.;.;.;.;.;.;.;.;.;.;.;.;.;.;.;.;.;.;.;.;.;.;.;.;.;.;.;.;.;.;.;.;.;.;.;.;.;.;.;.;.;.;.;.;.;.;.;.;q
q;.;.;.;.;.;.;.;.;.;.;.;.;.;.;.;.;.;.;.;.;.;.;.;.;.;.;.;.;.;.;.;.;.;.;.;.;.;.;.;.;.;.;.;.;.;.;.;.;.;.;.;.;.;.;.;.;.;.;.;.;.;.;d
d;.;.;.;.;.;.;.;.;.;.;.;.;.;.;.;.;.;.;.;.;.;.;.;.;.;.;.;.;.;.;.;.;.;.;.;.;.;.;.;.;.;.;.;.;.;.;.;.;.;.;.;.;.;.;.;.;.;.;.;.;.;.;q
q;.;.;.;.;.;.;.;.;.;.;.;.;.;.;.;.;.;.;.;.;.;.;.;.;.;.;.;.;.;.;.;.;.;.;.;.;.;.;.;.;.;.;.;.;.;.;.;.;.;.;.;.;.;.;.;.;.;.;.;.;.;.;d
d;.;q;q;q;q;q;q;q;q;q;q;q;q;q;q;q;.;.;d;d;d;d;d;d;d;d;d;d;d;.;.;.;.;q;q;q;q;q;q;q;q;q;q;q;q;.;.;d;d;d;d;d;d;d;d;d;d;d;d;d;d;.;q
q;.;q;q;q;q;q;q;q;q;q;q;q;q;q;q;q;.;.;d;d;d;d;d;d;d;d;d;d;d;.;.;.;.;q;q;q;q;q;q;q;q;q;q;q;q;.;.;d;d;d;d;d;d;d;d;d;d;d;d;d;d;.;d
d;.;q;q;q;q;q;q;q;q;q;q;q;q;q;q;q;.;.;d;d;d;d;d;d;d;d;d;d;d;.;.;.;.;q;q;q;q;q;q;q;q;q;q;q;q;.;.;d;d;d;d;d;d;d;d;d;d;d;d;d;d;.;q
q;.;q;q;q;q;q;q;q;q;q;q;q;q;q;q;q;.;.;d;d;d;d;d;d;d;d;d;d;d;.;.;.;.;q;q;q;q;q;q;q;q;q;q;q;q;.;.;d;d;d;d;d;d;d;d;d;d;d;d;d;d;.;d
d;.;q;q;q;q;q;q;q;q;q;q;q;q;q;q;q;.;.;d;d;d;d;d;d;d;d;d;d;d;.;.;.;.;q;q;q;q;q;q;q;q;q;q;q;q;.;.;d;d;d;d;d;d;d;d;d;d;d;d;d;d;.;q
q;.;q;q;q;q;q;q;q;q;q;q;q;q;q;q;q;.;.;d;d;d;d;d;d;d;d;d;d;d;.;.;.;.;q;q;q;q;q;q;q;q;q;q;q;q;.;.;d;d;d;d;d;d;d;d;d;d;d;d;d;d;.;d
d;.;q;q;q;q;q;q;q;q;q;q;q;q;q;q;q;.;.;d;d;d;d;d;d;d;d;d;d;d;.;.;.;.;q;q;q;q;q;q;q;q;q;q;q;q;.;.;d;d;d;d;d;d;d;d;d;d;d;d;d;d;.;q
q;.;q;q;q;q;q;q;q;q;q;q;q;q;q;q;q;.;.;d;d;d;d;d;d;d;d;d;d;d;.;.;.;.;q;q;q;q;q;q;q;q;q;q;q;q;.;.;d;d;d;d;d;d;d;d;d;d;d;d;d;d;.;d
d;.;q;q;q;q;q;q;q;q;q;q;q;q;q;q;q;.;.;d;d;d;d;d;d;d;d;d;d;d;.;.;.;.;q;q;q;q;q;q;q;q;q;q;q;q;.;.;d;d;d;d;d;d;d;d;d;d;d;d;d;d;.;q
q;.;q;q;q;q;q;q;q;q;q;q;q;q;q;q;q;.;.;d;d;d;d;d;d;d;d;d;d;d;.;.;.;.;q;q;q;q;q;q;q;q;q;q;q;q;.;.;d;d;d;d;d;d;d;d;d;d;d;d;d;d;.;d
d;.;q;q;q;q;q;q;q;q;q;q;q;q;q;q;q;.;.;d;d;d;d;d;d;d;d;d;d;d;.;.;.;.;q;q;q;q;q;q;q;q;q;q;q;q;.;.;d;d;d;d;d;d;d;d;d;d;d;d;d;d;.;q
q;.;.;.;.;.;.;.;.;.;.;.;.;.;.;.;.;.;.;.;.;.;.;.;.;.;.;.;.;.;.;.;.;.;.;.;.;.;.;.;.;.;.;.;.;.;.;.;.;.;.;.;.;.;.;.;.;.;.;.;.;.;.;d
d;.;.;.;.;.;.;.;.;.;.;.;.;.;.;.;.;.;.;.;.;.;.;.;.;.;.;.;.;.;.;.;.;.;.;.;.;.;.;.;.;.;.;.;.;.;.;.;.;.;.;.;.;.;.;.;.;.;.;.;.;.;.;q
q;.;.;.;.;.;.;.;.;.;.;.;.;.;.;.;.;.;.;.;.;.;.;.;.;.;.;.;.;.;.;.;.;.;.;.;.;.;.;.;.;.;.;.;.;.;.;.;.;.;.;.;.;.;.;.;.;.;.;.;.;.;.;d
d;.;d;d;d;d;d;d;d;d;d;d;d;d;d;d;d;.;.;q;q;q;q;q;q;q;q;q;q;q;.;.;.;.;d;d;d;d;d;d;d;d;d;d;d;d;.;.;q;q;q;q;q;q;q;q;q;q;q;q;q;q;.;q
q;.;d;d;d;d;d;d;d;d;d;d;d;d;d;d;d;.;.;q;q;q;q;q;q;q;q;q;q;q;.;.;.;.;d;d;d;d;d;d;d;d;d;d;d;d;.;.;q;q;q;q;q;q;q;q;q;q;q;q;q;q;.;d
d;.;d;d;d;d;d;d;d;d;d;d;d;d;d;d;d;.;.;q;q;q;q;q;q;q;q;q;q;q;.;.;.;.;d;d;d;d;d;d;d;d;d;d;d;d;.;.;q;q;q;q;q;q;q;q;q;q;q;q;q;q;.;q
q;.;d;d;d;d;d;d;d;d;d;d;d;d;d;d;d;.;.;q;q;q;q;q;q;q;q;q;q;q;.;.;.;.;d;d;d;d;d;d;d;d;d;d;d;d;.;.;q;q;q;q;q;q;q;q;q;q;q;q;q;q;.;d
d;.;d;d;d;d;d;d;d;d;d;d;d;d;d;d;d;.;.;q;q;q;q;q;q;q;q;q;q;q;.;.;.;.;d;d;d;d;d;d;d;d;d;d;d;d;.;.;q;q;q;q;q;q;q;q;q;q;q;q;q;q;.;q
q;.;d;d;d;d;d;d;d;d;d;d;d;d;d;d;d;.;.;q;q;q;q;q;q;q;q;q;q;q;.;.;.;.;d;d;d;d;d;d;d;d;d;d;d;d;.;.;q;q;q;q;q;q;q;q;q;q;q;q;q;q;.;d
d;.;d;d;d;d;d;d;d;d;d;d;d;d;d;d;d;.;.;q;q;q;q;q;q;q;q;q;q;q;.;.;.;.;d;d;d;d;d;d;d;d;d;d;d;d;.;.;q;q;q;q;q;q;q;q;q;q;q;q;q;q;.;q
q;.;d;d;d;d;d;d;d;d;d;d;d;d;d;d;d;.;.;q;q;q;q;q;q;q;q;q;q;q;.;.;.;.;d;d;d;d;d;d;d;d;d;d;d;d;.;.;q;q;q;q;q;q;q;q;q;q;q;q;q;q;.;d
d;.;d;d;d;d;d;d;d;d;d;d;d;d;d;d;d;.;.;q;q;q;q;q;q;q;q;q;q;q;.;.;.;.;d;d;d;d;d;d;d;d;d;d;d;d;.;.;q;q;q;q;q;q;q;q;q;q;q;q;q;q;.;q
q;.;d;d;d;d;d;d;d;d;d;d;d;d;d;d;d;.;.;q;q;q;q;q;q;q;q;q;q;q;.;.;.;.;d;d;d;d;d;d;d;d;d;d;d;d;.;.;q;q;q;q;q;q;q;q;q;q;q;q;q;q;.;d
d;.;d;d;d;d;d;d;d;d;d;d;d;d;d;d;d;.;.;q;q;q;q;q;q;q;q;q;q;q;.;.;.;.;d;d;d;d;d;d;d;d;d;d;d;d;.;.;q;q;q;q;q;q;q;q;q;q;q;q;q;q;.;q
q;.;d;d;d;d;d;d;d;d;d;d;d;d;d;d;d;.;.;q;q;q;q;q;q;q;q;q;q;q;.;.;.;.;d;d;d;d;d;d;d;d;d;d;d;d;.;.;q;q;q;q;q;q;q;q;q;q;q;q;q;q;.;d
d;.;d;d;d;d;d;d;d;d;d;d;d;d;d;d;d;.;.;q;q;q;q;q;q;q;q;q;q;q;.;.;.;.;d;d;d;d;d;d;d;d;d;d;d;d;.;.;q;q;q;q;q;q;q;q;q;q;q;q;q;q;.;q
q;.;.;.;.;.;.;.;.;.;.;.;.;.;.;.;.;.;.;.;.;.;.;.;.;.;.;.;.;.;.;.;.;.;.;.;.;.;.;.;.;.;.;.;.;.;.;.;.;.;.;.;.;.;.;.;.;.;.;.;.;.;.;d
d;q;d;q;d;q;d;q;d;q;d;q;d;q;d;q;d;q;d;q;d;q;d;q;d;q;d;q;d;q;d;q;d;q;d;q;d;q;d;q;d;q;d;q;d;q;d;q;d;q;d;q;d;q;d;q;d;G;G;J;1;4;<;3
