.;.;.;.;.;.;.;.;.;.;.;.;.;.;.;.;.;.;.;.;.;.;.;.;.;.;.;.;.;.;.;.;.;.;.;.;.;.;.;.;.;.;.;.;.;.;.;.;.;.;.;.;.;.;.;.;.;.;.;.;.;.;.;.
.;.;.;.;.;.;.;.;.;.;.;.;.;.;.;.;.;.;.;.;.;.;.;.;.;.;.;.;.;.;.;.;.;.;.;.;.;.;.;.;.;.;.;.;.;.;.;.;.;.;.;.;.;.;.;.;.;.;.;.;.;.;.;.
.;.;a;a;a;a;a;a;a;a;a;a;a;a;a;a;a;a;a;a;a;a;a;a;a;a;a;a;a;a;.;.;.;.;h;h;h;h;h;h;h;h;h;h;h;h;h;h;h;h;h;h;h;h;h;h;h;h;h;h;h;h;.;.
.;.;a;a;a;a;a;a;a;a;a;a;a;a;a;a;a;a;a;a;a;a;a;a;a;a;a;a;a;a;.;.;.;.;h;h;h;h;h;h;h;h;h;h;h;h;h;h;h;h;h;h;h;h;h;h;h;h;h;h;h;h;.;.
.;.;a;a;a;a;a;a;a;a;a;a;a;a;a;a;a;a;a;a;a;a;a;a;a;a;a;a;a;a;.;.;.;.;h;h;h;h;h;h;h;h;h;h;h;h;h;h;h;h;h;h;h;h;h;h;h;h;h;h;h;h;.;.
.;.;a;a;a;a;a;a;a;a;a;a;a;a;a;a;a;a;a;a;a;a;a;a;a;a;a;a;a;a;.;.;.;.;h;h;h;h;h;h;h;h;h;h;h;h;h;h;h;h;h;h;h;h;h;h;h;h;h;h;h;h;.;.
.;.;a;a;a;a;a;a;a;a;a;a;a;a;a;a;a;a;a;a;a;a;a;a;a;a;a;a;a;a;.;.;.;.;h;h;h;h;h;h;h;h;h;h;h;h;h;h;h;h;h;h;h;h;h;h;h;h;h;h;h;h;.;.
.;.;a;a;a;a;a;a;a;a;a;a;a;a;a;a;a;a;a;a;a;a;a;a;a;a;a;a;a;a;.;.;.;.;h;h;h;h;h;h;h;h;h;h;h;h;h;h;h;h;h;h;h;h;h;h;h;h;h;h;h;h;.;.
.;.;a;a;a;a;a;a;a;a;a;a;a;a;a;.;.;.;.;.;.;.;.;.;.;.;.;.;.;.;.;.;.;.;.;.;.;.;.;.;.;.;.;.;.;.;.;.;.;h;h;h;h;h;h;h;h;h;h;h;h;h;.;.
.;.;a;a;a;a;a;a;a;a;a;a;a;a;a;.;.;.;.;.;.;.;.;.;.;.;.;.;.;.;.;.;.;.;.;.;.;.;.;.;.;.;.;.;.;.;.;.;.;h;h;h;h;h;h;h;h;h;h;h;h;h;.;.
.;.;a;a;a;a;a;a;a;a;a;a;a;a;a;.;.;a;e;e;e;e;e;e;e;e;e;e;e;e;.;.;.;.;k;k;k;k;k;k;k;k;k;k;k;k;k;.;.;h;h;h;h;h;h;h;h;h;h;h;h;h;.;.
.;.;a;a;a;a;a;a;a;a;a;a;a;a;a;.;.;e;e;e;e;e;e;e;e;e;e;e;e;e;.;.;.;.;k;k;k;k;k;k;k;k;k;k;k;k;k;.;.;h;h;h;h;h;h;h;h;h;h;h;h;h;.;.
.;.;a;a;a;a;a;a;a;a;a;a;a;a;a;.;.;e;e;e;e;e;e;e;e;e;e;e;e;e;.;.;.;.;k;k;k;k;k;k;k;k;k;k;k;k;k;.;.;h;h;h;h;h;h;h;h;h;h;h;h;h;.;.
.;.;a;a;a;a;a;a;a;a;a;a;a;a;a;.;.;e;e;e;e;e;e;e;e;e;e;e;e;e;.;.;.;.;k;k;k;k;k;k;k;k;k;k;k;k;k;.;.;h;h;h;h;h;h;h;h;h;h;h;h;h;.;.
.;.;a;a;a;a;a;a;a;a;a;a;a;a;a;.;.;e;e;e;e;e;e;e;e;e;e;e;e;e;.;.;.;.;k;k;k;k;k;k;k;k;k;k;k;k;k;.;.;h;h;h;h;h;h;h;h;h;h;h;h;h;.;.
.;.;a;a;a;a;a;a;a;a;a;a;a;a;a;.;.;e;e;e;e;e;e;e;e;e;e;e;e;e;.;.;.;.;k;k;k;k;k;k;k;k;k;k;k;k;k;.;.;h;h;h;h;h;h;h;h;h;h;h;h;h;.;.
.;.;.;.;.;.;.;.;.;.;.;.;.;.;.;.;.;e;e;e;e;e;e;e;e;e;e;e;e;e;.;.;.;.;k;k;k;k;k;k;k;k;k;k;k;k;k;.;.;.;.;.;.;.;.;.;.;.;.;.;.;.;.;.
.;.;.;.;.;.;.;.;.;.;.;.;.;.;.;.;.;e;e;e;e;e;e;e;e;e;e;e;e;e;.;.;.;.;k;k;k;k;k;k;k;k;k;k;k;k;k;.;.;.;.;.;.;.;.;.;.;.;.;.;.;.;.;.
.;.;e;e;e;e;e;e;e;e;e;e;e;e;e;e;e;e;e;e;e;e;e;e;e;e;e;e;e;e;.;.;.;.;k;k;k;k;k;k;k;k;k;k;k;k;k;k;k;k;k;k;k;k;k;k;k;k;k;k;k;k;.;.
.;.;e;e;e;e;e;e;e;e;e;e;e;e;e;e;e;e;e;e;e;e;e;e;e;e;e;e;e;e;.;.;.;.;k;k;k;k;k;k;k;k;k;k;k;k;k;k;k;k;k;k;k;k;k;k;k;k;k;k;k;k;.;.
.;.;e;e;e;e;e;e;e;e;e;e;e;e;e;e;e;e;e;e;e;e;e;e;e;e;e;e;e;e;.;.;.;.;k;k;k;k;k;k;k;k;k;k;k;k;k;k;k;k;k;k;k;k;k;k;k;k;k;k;k;k;.;.
.;.;e;e;e;e;e;e;e;e;e;e;e;e;e;e;e;e;e;e;e;e;e;e;e;e;e;e;e;e;.;.;.;.;k;k;k;k;k;k;k;k;k;k;k;k;k;k;k;k;k;k;k;k;k;k;k;k;k;k;k;k;.;.
.;.;e;e;e;e;e;e;e;e;e;e;e;e;e;e;e;e;e;e;e;e;e;e;e;e;e;e;e;e;.;.;.;.;k;k;k;k;k;k;k;k;k;k;k;k;k;k;k;k;k;k;k;k;k;k;k;k;k;k;k;k;.;.
.;.;e;e;e;e;e;e;e;e;e;e;e;e;e;e;e;e;e;e;e;e;e;e;e;e;e;e;e;e;.;.;.;.;k;k;k;k;k;k;k;k;k;k;k;k;k;k;k;k;k;k;k;k;k;k;k;k;k;k;k;k;.;.
.;.;.;.;.;.;.;.;.;.;.;.;.;.;.;.;.;e;e;e;e;e;e;e;e;e;e;e;e;e;.;.;.;.;k;k;k;k;k;k;k;k;k;k;k;k;k;.;.;.;.;.;.;.;.;.;.;.;.;.;.;.;.;.
.;.;.;.;.;.;.;.;.;.;.;.;.;.;.;.;.;e;e;e;e;e;e;e;e;e;e;e;e;e;.;.;.;.;k;k;k;k;k;k;k;k;k;k;k;k;k;.;.;.;.;.;.;.;.;.;.;.;.;.;.;;.;.
.;.;m;m;m;m;m;m;m;m;m;m;m;m;m;.;.;e;e;e;e;e;e;e;e;e;e;e;e;e;.;.;.;.;k;k;k;k;k;k;k;k;k;k;k;k;k;.;.;t;t;t;t;t;t;t;t;t;t;t;t;t;.;.
.;.;m;m;m;m;m;m;m;m;m;m;m;m;m;.;.;e;e;e;e;e;e;e;e;e;e;e;e;e;.;.;.;.;k;k;k;k;k;k;k;k;k;k;k;k;k;.;.;t;t;t;t;t;t;t;t;t;t;t;t;t;.;.
.;.;m;m;m;m;m;m;m;m;m;m;m;m;m;.;.;e;e;e;e;e;e;e;e;e;e;e;e;e;.;.;.;.;k;k;k;k;k;k;k;k;k;k;k;k;k;.;.;t;t;t;t;t;t;t;t;t;t;t;t;t;.;.
.;.;m;m;m;m;m;m;m;m;m;m;m;m;m;.;.;e;e;e;e;e;e;e;e;e;e;e;e;e;.;.;.;.;k;k;k;k;k;k;k;k;k;k;k;k;k;.;.;t;t;t;t;t;t;t;t;t;t;t;t;t;.;.
.;.;m;m;m;m;m;m;m;m;m;m;m;m;m;.;.;e;e;e;e;e;e;e;e;e;e;e;e;e;.;.;.;.;k;k;k;k;k;k;k;k;k;k;k;k;k;.;.;t;t;t;t;t;t;t;t;t;t;t;t;t;.;.
.;.;m;m;m;m;m;m;m;m;m;m;m;m;m;.;.;e;e;e;e;e;e;e;e;e;e;e;e;e;.;.;.;.;k;k;k;k;k;k;k;k;k;k;k;k;k;.;.;t;t;t;t;t;t;t;t;t;t;t;t;t;.;.
.;.;m;m;m;m;m;m;m;m;m;m;m;m;m;.;.;.;.;.;.;.;.;.;.;.;.;.;.;.;.;.;.;.;.;.;.;.;.;.;.;.;.;.;.;.;.;.;.;t;t;t;t;t;t;t;t;t;t;t;t;t;.;.
.;.;m;m;m;m;m;m;m;m;m;m;m;m;m;.;.;.;.;.;.;.;.;.;.;.;.;.;.;.;.;.;.;.;.;.;.;.;.;.;.;.;.;.;.;.;.;.;.;t;t;t;t;t;t;t;t;t;t;t;t;t;.;.
.;.;m;m;m;m;m;m;m;m;m;m;m;m;m;m;m;m;m;m;m;m;m;m;m;m;m;m;m;m;.;.;.;.;t;t;t;t;t;t;t;t;t;t;t;t;t;t;t;t;t;t;t;t;t;t;t;t;t;t;t;t;.;.
.;.;m;m;m;m;m;m;m;m;m;m;m;m;m;m;m;m;m;m;m;m;m;m;m;m;m;m;m;m;.;.;.;.;t;t;t;t;t;t;t;t;t;t;t;t;t;t;t;t;t;t;t;t;t;t;t;t;t;t;t;t;.;.
.;.;m;m;m;m;m;m;m;m;m;m;m;m;m;m;m;m;m;m;m;m;m;m;m;m;m;m;m;m;.;.;.;.;t;t;t;t;t;t;t;t;t;t;t;t;t;t;t;t;t;t;t;t;t;t;t;t;t;t;t;t;.;.
.;.;m;m;m;m;m;m;m;m;m;m;m;m;m;m;m;m;m;m;m;m;m;m;m;m;m;m;m;m;.;.;.;.;t;t;t;t;t;t;t;t;t;t;t;t;t;t;t;t;t;t;t;t;t;t;t;t;t;t;t;t;.;.
.;.;m;m;m;m;m;m;m;m;m;m;m;m;m;m;m;m;m;m;m;m;m;m;m;m;m;m;m;m;.;.;.;.;t;t;t;t;t;t;t;t;t;t;t;t;t;t;t;t;t;t;t;t;t;t;t;t;t;t;t;t;.;.
.;.;m;m;m;m;m;m;m;m;m;m;m;m;m;m;m;m;m;m;m;m;m;m;m;m;m;m;m;m;.;.;.;.;t;t;t;t;t;t;t;t;t;t;t;t;t;t;t;t;t;t;t;t;t;t;t;t;t;t;t;t;.;.
.;.;.;.;.;.;.;.;.;.;.;.;.;.;.;.;.;.;.;.;.;.;.;.;.;.;.;.;.;.;.;.;.;.;.;.;.;.;.;.;.;.;.;.;.;.;.;.;.;.;.;.;.;.;.;.;.;.;.;.;.;.;.;.
.;.;.;.;.;.;.;.;.;.;.;.;.;.;.;.;.;.;.;.;.;.;.;.;.;.;.;.;.;.;.;.;.;.;.;.;.;.;.;.;.;.;.;.;.;.;.;.;.;.;.;.;.;.;.;.;.;.;.;.;.;.;.;.
.;.;x;x;x;x;x;x;x;x;x;x;x;x;x;x;x;x;x;x;x;x;x;x;x;x;x;x;x;x;.;.;.;.;1;1;1;1;1;1;1;1;1;1;1;1;1;1;1;1;1;1;1;1;1;1;1;1;1;1;1;1;.;.
.;.;x;x;x;x;x;x;x;x;x;x;x;x;x;x;x;x;x;x;x;x;x;x;x;x;x;x;x;x;.;.;.;.;1;1;1;1;1;1;1;1;1;1;1;1;1;1;1;1;1;1;1;1;1;1;1;1;1;1;1;1;.;.
.;.;x;x;x;x;x;x;x;x;x;x;x;x;x;x;x;x;x;x;x;x;x;x;x;x;x;x;x;x;.;.;.;.;1;1;1;1;1;1;1;1;1;1;1;1;1;1;1;1;1;1;1;1;1;1;1;1;1;1;1;1;.;.
.;.;x;x;x;x;x;x;x;x;x;x;x;x;x;x;x;x;x;x;x;x;x;x;x;x;x;x;x;x;.;.;.;.;1;1;1;1;1;1;1;1;1;1;1;1;1;1;1;1;1;1;1;1;1;1;1;1;1;1;1;1;.;.
.;.;x;x;x;x;x;x;x;x;x;x;x;x;x;x;x;x;x;x;x;x;x;x;x;x;x;x;x;x;.;.;.;.;1;1;1;1;1;1;1;1;1;1;1;1;1;1;1;1;1;1;1;1;1;1;1;1;1;1;1;1;.;.
.;.;x;x;x;x;x;x;x;x;x;x;x;x;x;x;x;x;x;x;x;x;x;x;x;x;x;x;x;x;.;.;.;.;1;1;1;1;1;1;1;1;1;1;1;1;1;1;1;1;1;1;1;1;1;1;1;1;1;1;1;1;.;.
.;.;x;x;x;x;x;x;x;x;x;.;.;.;.;.;.;.;.;.;.;x;x;x;x;x;x;x;x;x;.;.;.;.;1;1;1;1;1;1;1;1;1;.;.;.;.;.;.;.;.;.;.;1;1;1;1;1;1;1;1;1;.;.
.;.;x;x;x;x;x;x;x;x;x;.;.;.;.;.;.;.;.;.;.;x;x;x;x;x;x;x;x;x;.;.;.;.;1;1;1;1;1;1;1;1;1;.;.;.;.;.;.;.;.;.;.;1;1;1;1;1;1;1;1;1;.;.
.;.;x;x;x;x;x;x;x;x;x;.;.;.;.;.;.;.;.;.;.;x;x;x;x;x;x;x;x;x;.;.;.;.;1;1;1;1;1;1;1;1;1;.;.;.;.;.;.;.;.;.;.;1;1;1;1;1;1;1;1;1;.;.
.;.;x;x;x;x;x;x;x;x;x;.;.;.;.;.;.;.;.;.;.;x;x;x;x;x;x;x;x;x;.;.;.;.;1;1;1;1;1;1;1;1;1;.;.;.;.;.;.;.;.;.;.;1;1;1;1;1;1;1;1;1;.;.
.;.;x;x;x;x;x;x;x;x;x;.;.;.;.;.;.;.;.;.;.;x;x;x;x;x;x;x;x;x;.;.;.;.;1;1;1;1;1;1;1;1;1;.;.;.;.;.;.;.;.;.;.;1;1;1;1;1;1;1;1;1;.;.
.;.;x;x;x;x;x;x;x;x;x;.;.;.;.;.;.;.;.;.;.;x;x;x;x;x;x;x;x;x;.;.;.;.;1;1;1;1;1;1;1;1;1;.;.;.;.;.;.;.;.;.;.;1;1;1;1;1;1;1;1;1;.;.
.;.;x;x;x;x;x;x;x;x;x;.;.;.;.;.;.;.;.;.;.;x;x;x;x;x;x;x;x;x;.;.;.;.;1;1;1;1;1;1;1;1;1;.;.;.;.;.;.;.;.;.;.;1;1;1;1;1;1;1;1;1;.;.
.;.;x;x;x;x;x;x;x;x;x;.;.;.;.;.;.;.;.;.;.;x;x;x;x;x;x;x;x;x;.;.;.;.;1;1;1;1;1;1;1;1;1;.;.;.;.;.;.;.;.;.;.;1;1;1;1;1;1;1;1;1;.;.
.;.;x;x;x;x;x;x;x;x;x;.;.;.;.;.;.;.;.;.;.;x;x;x;x;x;x;x;x;x;.;.;.;.;1;1;1;1;1;1;1;1;1;.;.;.;.;.;.;.;.;.;.;1;1;1;1;1;1;1;1;1;.;.
.;.;x;x;x;x;x;x;x;x;x;.;.;.;.;.;.;.;.;.;.;x;x;x;x;x;x;x;x;x;.;.;.;.;1;1;1;1;1;1;1;1;1;.;.;.;.;.;.;.;.;.;.;1;1;1;1;1;1;1;1;1;.;.
.;.;x;x;x;x;x;x;x;x;x;x;x;x;x;x;x;x;x;x;x;x;x;x;x;x;x;x;x;x;.;.;.;.;1;1;1;1;1;1;1;1;1;1;1;1;1;1;1;1;1;1;1;1;1;1;1;1;1;1;1;1;.;.
.;.;x;x;x;x;x;x;x;x;x;x;x;x;x;x;x;x;x;x;x;x;x;x;x;x;x;x;x;x;.;.;.;.;1;1;1;1;1;1;1;1;1;1;1;1;1;1;1;1;1;1;1;1;1;1;1;1;1;1;1;1;.;.
.;.;x;x;x;x;x;x;x;x;x;x;x;x;x;x;x;x;x;x;x;x;x;x;x;x;x;x;x;x;.;.;.;.;1;1;1;1;1;1;1;1;1;1;1;1;1;1;1;1;1;1;1;1;1;1;1;1;1;1;1;1;.;.
.;.;x;x;x;x;x;x;x;x;x;x;x;x;x;x;x;x;x;x;x;x;x;x;x;x;x;x;x;x;.;.;.;.;1;1;1;1;1;1;1;1;1;1;1;1;1;1;1;1;1;1;1;1;1;1;1;1;1;1;1;1;.;.
.;.;x;x;x;x;x;x;x;x;x;x;x;x;x;x;x;x;x;x;x;x;x;x;x;x;x;x;x;x;.;.;.;.;1;1;1;1;1;1;1;1;1;1;1;1;1;1;1;1;1;1;1;1;1;1;1;1;1;1;1;1;.;.
.;.;x;x;x;x;x;x;x;x;x;x;x;x;x;x;x;x;x;x;x;x;x;x;x;x;x;x;x;x;.;.;.;.;1;1;1;1;1;1;1;1;1;1;1;1;1;1;1;1;1;1;1;1;1;1;1;1;1;1;1;1;.;.
