.;.;.;.;.;.;.;.;.;.;.;.;.;.;.;.;.;.;.;.;.;.;.;.;.;.;.;.;.;.;.;.;.;.;.;.;.;.;.;.;.;.;.;.;.;.;.;.;.;.;.;.;.;.;.;.;.;.;.;.;.;.;.;.
.;.;.;.;.;.;.;.;.;.;.;.;.;.;.;.;.;.;.;.;.;.;.;.;.;.;.;.;.;.;.;.;.;.;.;.;.;.;.;.;.;.;.;.;.;.;.;.;.;.;.;.;.;.;.;.;.;.;.;.;.;.;.;.
.;.;.;.;.;.;.;.;.;.;.;.;.;.;.;.;.;.;.;.;.;.;.;.;.;.;.;.;.;.;.;.;.;.;.;.;.;.;.;.;.;.;.;.;.;.;.;.;.;.;.;.;.;.;.;.;.;.;.;.;.;.;.;.
.;.;.;.;.;.;.;.;.;.;.;.;.;.;.;.;.;.;.;.;.;.;.;.;.;.;.;.;.;.;.;.;.;.;.;.;.;.;.;.;.;.;.;.;.;.;.;.;.;.;.;.;.;.;.;.;.;.;.;.;.;.;.;.
.;.;.;.;.;.;.;.;.;.;.;.;.;.;.;.;.;.;.;.;.;.;.;.;.;.;.;.;.;.;.;.;.;.;.;.;.;.;.;.;.;.;.;.;.;.;.;.;.;.;.;.;.;.;.;.;.;.;.;.;.;.;.;.
.;.;.;.;.;.;.;.;.;.;.;.;.;.;.;.;.;.;.;.;.;.;.;.;.;.;.;.;.;.;.;.;.;.;.;.;.;.;.;.;.;.;.;.;.;.;.;.;.;.;.;.;.;.;.;.;.;.;.;.;.;.;.;.
.;.;.;.;.;.;.;.;.;.;.;.;.;.;.;.;.;.;.;.;.;.;.;.;.;.;.;.;.;.;.;.;.;.;.;.;.;.;.;.;.;.;.;.;.;.;.;.;.;.;.;.;.;.;.;.;.;.;.;.;.;.;.;.
.;.;.;.;.;.;.;.;.;.;.;.;.;.;.;.;.;.;.;.;.;.;.;.;.;.;.;.;.;.;.;.;.;.;.;.;.;.;.;.;.;.;.;.;.;.;.;.;.;.;.;.;.;.;.;.;.;.;.;.;.;.;.;.
.;.;.;.;.;.;.;.;.;.;.;.;.;.;.;.;.;.;.;.;.;.;.;.;.;.;.;.;.;.;.;.;.;.;.;.;.;.;.;.;.;.;.;.;.;.;.;.;.;.;.;.;.;.;.;.;.;.;.;.;.;.;.;.
.;.;.;.;.;.;.;.;.;.;.;.;.;.;.;.;.;.;.;.;.;.;.;.;.;.;.;.;.;.;.;.;.;.;.;.;.;.;.;.;.;.;.;.;.;.;.;.;.;.;.;.;.;.;.;.;.;.;.;.;.;.;.;.
.;.;.;.;.;.;.;.;.;.;.;.;.;.;.;.;.;.;.;.;.;.;.;.;.;.;.;.;.;.;.;.;.;.;.;.;.;.;.;.;.;.;.;.;.;.;.;.;.;.;.;.;.;.;.;.;.;.;.;.;.;.;.;.
.;.;.;.;.;.;.;.;.;.;.;.;.;.;.;.;.;.;.;.;.;.;.;.;.;.;.;.;.;.;.;.;.;.;.;.;.;.;.;.;.;.;.;.;.;.;.;.;.;.;.;.;.;.;.;.;.;.;.;.;.;.;.;.
.;.;.;.;.;.;.;.;.;.;.;.;.;.;.;.;.;.;.;.;.;.;.;.;.;.;.;.;.;.;.;.;.;.;.;.;.;.;.;.;.;.;.;.;.;.;.;.;.;.;.;.;.;.;.;.;.;.;.;.;.;.;.;.
.;.;.;.;.;.;.;.;.;.;.;.;.;.;.;.;.;.;.;.;.;.;.;.;.;.;.;.;.;.;.;.;.;.;.;.;.;.;.;.;.;.;.;.;.;.;.;.;.;.;.;.;.;.;.;.;.;.;.;.;.;.;.;.
.;.;.;.;.;.;.;.;.;.;.;.;.;.;.;.;.;.;.;.;.;.;.;.;.;.;.;.;.;.;.;.;.;.;.;.;.;.;.;.;.;.;.;.;.;.;.;.;.;.;.;.;.;.;.;.;.;.;.;.;.;.;.;.
.;.;.;.;.;.;.;.;.;.;.;.;.;.;.;.;.;.;.;.;.;.;.;.;.;.;.;.;.;.;.;.;.;.;.;.;.;.;.;.;.;.;.;.;.;.;.;.;.;.;.;.;.;.;.;.;.;.;.;.;.;.;.;.
.;.;.;.;.;.;.;.;.;.;.;.;.;.;.;.;.;.;.;.;.;.;.;.;.;.;.;.;.;.;.;.;.;.;.;.;.;.;.;.;.;.;.;.;.;.;.;.;.;.;.;.;.;.;.;.;.;.;.;.;.;.;.;.
.;.;.;.;.;.;.;.;.;.;.;.;.;.;.;.;.;.;.;.;.;.;.;.;.;.;.;.;.;.;.;.;.;.;.;.;.;.;.;.;.;.;.;.;.;.;.;.;.;.;.;.;.;.;.;.;.;.;.;.;.;.;.;.
.;.;.;.;.;.;.;.;.;.;.;.;.;.;.;.;.;.;.;.;.;.;.;.;.;.;.;.;.;.;.;.;.;.;.;.;.;.;.;.;.;.;.;.;.;.;.;.;.;.;.;.;.;.;.;.;.;.;.;.;.;.;.;.
.;.;.;.;.;.;.;.;.;.;.;.;.;.;.;.;.;.;.;.;.;.;.;.;.;.;.;.;.;.;.;.;.;.;.;.;.;.;.;.;.;.;.;.;.;.;.;.;.;.;.;.;.;.;.;.;.;.;.;.;.;.;.;.
.;.;.;.;.;.;.;.;.;.;.;.;.;.;.;.;.;.;.;.;.;.;.;.;.;.;.;.;.;.;.;.;.;.;.;.;.;.;.;.;.;.;.;.;.;.;.;.;.;.;.;.;.;.;.;.;.;.;.;.;.;.;.;.
.;.;.;.;.;.;.;.;.;.;.;.;.;.;.;.;.;.;.;.;.;.;.;.;.;.;.;.;.;.;.;.;.;.;.;.;.;.;.;.;.;.;.;.;.;.;.;.;.;.;.;.;.;.;.;.;.;.;.;.;.;.;.;.
.;.;.;.;.;.;.;.;.;p;p;p;p;p;p;p;p;p;p;p;p;p;p;p;p;p;p;p;p;p;p;p;p;p;p;p;p;p;p;p;p;p;p;p;p;p;p;p;p;p;p;p;p;p;p;.;.;.;.;.;.;.;.;.
.;.;.;.;.;.;.;.;.;p;p;p;p;p;p;p;p;p;p;p;p;p;p;p;p;p;p;p;p;p;p;p;p;p;p;p;p;p;p;p;p;p;p;p;p;p;p;p;p;p;p;p;p;p;p;.;.;.;.;.;.;.;.;.
.;.;.;.;.;.;.;.;.;p;p;q;q;q;q;q;q;q;q;q;q;q;q;q;q;q;q;q;q;q;q;q;q;q;q;q;q;q;q;q;q;q;q;q;q;q;q;q;q;q;q;q;q;p;p;.;.;.;.;.;.;.;.;.
.;.;.;.;.;.;.;.;.;p;p;q;q;q;q;q;q;q;q;q;q;q;q;q;q;q;q;q;q;q;q;q;q;q;q;q;q;q;q;q;q;q;q;q;q;q;q;q;q;q;q;q;q;p;p;.;.;.;.;.;.;.;.;.
.;.;.;.;.;.;.;.;.;p;p;q;q;q;q;q;q;q;q;q;q;q;q;q;q;q;q;q;q;q;q;q;q;q;q;q;q;q;q;q;q;q;q;q;q;q;q;q;q;q;q;q;q;p;p;.;.;.;.;.;.;.;.;.
.;.;.;.;.;.;.;.;.;p;p;q;q;q;q;q;q;q;q;q;q;q;q;q;q;q;q;q;q;q;q;q;q;q;q;q;q;q;q;q;q;q;q;q;q;q;q;q;q;q;q;q;q;p;p;.;.;.;.;.;.;.;.;.
.;.;.;.;.;.;.;.;.;p;p;q;q;q;q;q;q;q;q;q;q;q;q;q;q;q;q;q;q;q;q;q;q;q;q;q;q;q;q;q;q;q;q;q;q;q;q;q;q;q;q;q;q;p;p;.;.;.;.;.;.;.;.;.
.;.;.;.;.;.;.;.;.;p;p;q;q;q;q;q;q;q;q;q;q;q;q;q;q;q;q;q;q;q;q;q;q;q;q;q;q;q;q;q;q;q;q;q;q;q;q;q;q;q;q;q;q;p;p;.;.;.;.;.;.;.;.;.
.;.;.;.;.;.;.;.;.;p;p;q;q;q;q;q;q;q;q;q;q;q;q;q;q;q;q;q;q;q;q;q;q;q;q;q;q;q;q;q;q;q;q;q;q;q;q;q;q;q;q;q;q;p;p;.;.;.;.;.;.;.;.;.
.;.;.;.;.;.;.;.;.;p;p;q;q;q;q;q;q;q;q;q;q;q;q;q;q;q;q;q;q;G;G;J;1;4;!;q;q;q;q;q;q;q;q;q;q;q;q;q;q;q;q;q;q;p;p;.;.;.;.;.;.;.;.;.
.;.;.;.;.;.;.;.;.;p;p;q;q;q;q;q;q;q;q;q;q;q;q;q;q;q;q;q;q;q;q;q;q;q;q;q;q;q;q;q;q;q;q;q;q;q;q;q;q;q;q;q;q;p;p;.;.;.;.;.;.;.;.;.
.;.;.;.;.;.;.;.;.;p;p;q;q;q;q;q;q;q;q;q;q;q;q;q;q;q;q;q;q;q;q;q;q;q;q;q;q;q;q;q;q;q;q;q;q;q;q;q;q;q;q;q;q;p;p;.;.;.;.;.;.;.;.;.
.;.;.;.;.;.;.;.;.;p;p;q;q;q;q;q;q;q;q;q;q;q;q;q;q;q;q;q;q;q;q;q;q;q;q;q;q;q;q;q;q;q;q;q;q;q;q;q;q;q;q;q;q;p;p;.;.;.;.;.;.;.;.;.
.;.;.;.;.;.;.;.;.;p;p;q;q;q;q;q;q;q;q;q;q;q;q;q;q;q;q;q;q;q;q;q;q;q;q;q;q;q;q;q;q;q;q;q;q;q;q;q;q;q;q;q;q;p;p;.;.;.;.;.;.;.;.;.
.;.;.;.;.;.;.;.;.;p;p;q;q;q;q;q;q;q;q;q;q;q;q;q;q;q;q;q;q;q;q;q;q;q;q;q;q;q;q;q;q;q;q;q;q;q;q;q;q;q;q;q;q;p;p;.;.;.;.;.;.;.;.;.
.;.;.;.;.;.;.;.;.;p;p;q;q;q;q;q;q;q;q;q;q;q;q;q;q;q;q;q;q;q;q;q;q;q;q;q;q;q;q;q;q;q;q;q;q;q;q;q;q;q;q;q;q;p;p;.;.;.;.;.;.;.;.;.
.;.;.;.;.;.;.;.;.;p;p;q;q;q;q;q;q;q;q;q;q;q;q;q;q;q;q;q;q;q;q;q;q;q;q;q;q;q;q;q;q;q;q;q;q;q;q;q;q;q;q;q;q;p;p;.;.;.;.;.;.;.;.;.
.;.;.;.;.;.;.;.;.;p;p;q;q;q;q;q;q;q;q;q;q;q;q;q;q;q;q;q;q;q;q;q;q;q;q;q;q;q;q;q;q;q;q;q;q;q;q;q;q;q;q;q;q;p;p;.;.;.;.;.;.;.;.;.
.;.;.;.;.;.;.;.;.;p;p;p;p;p;p;p;p;p;p;p;p;p;p;p;p;p;p;p;p;p;p;p;p;p;p;p;p;p;p;p;p;p;p;p;p;p;p;p;p;p;p;p;p;p;p;.;.;.;.;.;.;.;.;.
.;.;.;.;.;.;.;.;.;p;p;p;p;p;p;p;p;p;p;p;p;p;p;p;p;p;p;p;p;p;p;p;p;p;p;p;p;p;p;p;p;p;p;p;p;p;p;p;p;p;p;p;p;p;p;.;.;.;.;.;.;.;.;.
.;.;.;.;.;.;.;.;.;.;.;.;.;.;.;.;.;.;.;.;.;.;.;.;.;.;.;.;.;.;.;.;.;.;.;.;.;.;.;.;.;.;.;.;.;.;.;.;.;.;.;.;.;.;.;.;.;.;.;.;.;.;.;.
.;.;.;.;.;.;.;.;.;.;.;.;.;.;.;.;.;.;.;.;.;.;.;.;.;.;.;.;.;.;.;.;.;.;.;.;.;.;.;.;.;.;.;.;.;.;.;.;.;.;.;.;.;.;.;.;.;.;.;.;.;.;.;.
.;.;.;.;.;.;.;.;.;.;.;.;.;.;.;.;.;.;.;.;.;.;.;.;.;.;.;.;.;.;.;.;.;.;.;.;.;.;.;.;.;.;.;.;.;.;.;.;.;.;.;.;.;.;.;.;.;.;.;.;.;.;.;.
.;.;.;.;.;.;.;.;.;.;.;.;.;.;.;.;.;.;.;.;.;.;.;.;.;.;.;.;.;.;.;.;.;.;.;.;.;.;.;.;.;.;.;.;.;.;.;.;.;.;.;.;.;.;.;.;.;.;.;.;.;.;.;.
.;.;.;.;.;.;.;.;.;.;.;.;.;.;.;.;.;.;.;.;.;.;.;.;.;.;.;.;.;.;.;.;.;.;.;.;.;.;.;.;.;.;.;.;.;.;.;.;.;.;.;.;.;.;.;.;.;.;.;.;.;.;.;.
.;.;.;.;.;.;.;.;.;.;.;.;.;.;.;.;.;.;.;.;.;.;.;.;.;.;.;.;.;.;.;.;.;.;.;.;.;.;.;.;.;.;.;.;.;.;.;.;.;.;.;.;.;.;.;.;.;.;.;.;.;.;.;.
.;.;.;.;.;.;.;.;.;.;.;.;.;.;.;.;.;.;.;.;.;.;.;.;.;.;.;.;.;.;.;.;.;.;.;.;.;.;.;.;.;.;.;.;.;.;.;.;.;.;.;.;.;.;.;.;.;.;.;.;.;.;.;.
.;.;.;.;.;.;.;.;.;.;.;.;.;.;.;.;.;.;.;.;.;.;.;.;.;.;.;.;.;.;.;.;.;.;.;.;.;.;.;.;.;.;.;.;.;.;.;.;.;.;.;.;.;.;.;.;.;.;.;.;.;.;.;.
.;.;.;.;.;.;.;.;.;.;.;.;.;.;.;.;.;.;.;.;.;.;.;.;.;.;.;.;.;.;.;.;.;.;.;.;.;.;.;.;.;.;.;.;.;.;.;.;.;.;.;.;.;.;.;.;.;.;.;.;.;.;.;.
.;.;.;.;.;.;.;.;.;.;.;.;.;.;.;.;.;.;.;.;.;.;.;.;.;.;.;.;.;.;.;.;.;.;.;.;.;.;.;.;.;.;.;.;.;.;.;.;.;.;.;.;.;.;.;.;.;.;.;.;.;.;.;.
.;.;.;.;.;.;.;.;.;.;.;.;.;.;.;.;.;.;.;.;.;.;.;.;.;.;.;.;.;.;.;.;.;.;.;.;.;.;.;.;.;.;.;.;.;.;.;.;.;.;.;.;.;.;.;.;.;.;.;.;.;.;.;.
.;.;.;.;.;.;.;.;.;.;.;.;.;.;.;.;.;.;.;.;.;.;.;.;.;.;.;.;.;.;.;.;.;.;.;.;.;.;.;.;.;.;.;.;.;.;.;.;.;.;.;.;.;.;.;.;.;.;.;.;.;.;.;.
.;.;.;.;.;.;.;.;.;.;.;.;.;.;.;.;.;.;.;.;.;.;.;.;.;.;.;.;.;.;.;.;.;.;.;.;.;.;.;.;.;.;.;.;.;.;.;.;.;.;.;.;.;.;.;.;.;.;.;.;.;.;.;.
.;.;.;.;.;.;.;.;.;.;.;.;.;.;.;.;.;.;.;.;.;.;.;.;.;.;.;.;.;.;.;.;.;.;.;.;.;.;.;.;.;.;.;.;.;.;.;.;.;.;.;.;.;.;.;.;.;.;.;.;.;.;.;.
.;.;.;.;.;.;.;.;.;.;.;.;.;.;.;.;.;.;.;.;.;.;.;.;.;.;.;.;.;.;.;.;.;.;.;.;.;.;.;.;.;.;.;.;.;.;.;.;.;.;.;.;.;.;.;.;.;.;.;.;.;.;.;.
.;.;.;.;.;.;.;.;.;.;.;.;.;.;.;.;.;.;.;.;.;.;.;.;.;.;.;.;.;.;.;.;.;.;.;.;.;.;.;.;.;.;.;.;.;.;.;.;.;.;.;.;.;.;.;.;.;.;.;.;.;.;.;.
.;.;.;.;.;.;.;.;.;.;.;.;.;.;.;.;.;.;.;.;.;.;.;.;.;.;.;.;.;.;.;.;.;.;.;.;.;.;.;.;.;.;.;.;.;.;.;.;.;.;.;.;.;.;.;.;.;.;.;.;.;.;.;.
.;.;.;.;.;.;.;.;.;.;.;.;.;.;.;.;.;.;.;.;.;.;.;.;.;.;.;.;.;.;.;.;.;.;.;.;.;.;.;.;.;.;.;.;.;.;.;.;.;.;.;.;.;.;.;.;.;.;.;.;.;.;.;.
.;.;.;.;.;.;.;.;.;.;.;.;.;.;.;.;.;.;.;.;.;.;.;.;.;.;.;.;.;.;.;.;.;.;.;.;.;.;.;.;.;.;.;.;.;.;.;.;.;.;.;.;.;.;.;.;.;.;.;.;.;.;.;.
.;.;.;.;.;.;.;.;.;.;.;.;.;.;.;.;.;.;.;.;.;.;.;.;.;.;.;.;.;.;.;.;.;.;.;.;.;.;.;.;.;.;.;.;.;.;.;.;.;.;.;.;.;.;.;.;.;.;.;.;.;.;.;.
.;.;.;.;.;.;.;.;.;.;.;.;.;.;.;.;.;.;.;.;.;.;.;.;.;.;.;.;.;.;.;.;.;.;.;.;.;.;.;.;.;.;.;.;.;.;.;.;.;.;.;.;.;.;.;.;.;.;.;.;.;.;.;.
.;.;.;.;.;.;.;.;.;.;.;.;.;.;.;.;.;.;.;.;.;.;.;.;.;.;.;.;.;.;.;.;.;.;.;.;.;.;.;.;.;.;.;.;.;.;.;.;.;.;.;.;.;.;.;.;.;.;.;.;.;.;.;.
